Date,date,ABMI,YBHA,KTMS,KTMR,KTMQ,KTMW,KTMU,KTMT,KTMZ,KTMY,KTMX,KTNC,KTNB,KTMW_gdp,KTMX_gdp,KTMU_gdp,KTMY_gdp,KTMS_gdp,KTMQ_gdp,KTMR_gdp,KTNC_gdp,KTMZ_gdp,KTMT_gdp,KTNB_gdp
1948,1948,365418,11425,-64,641,577,2240,18816,25555,43345,-216,2456,806,42539,.19606127,.21496718,1.6469146,-.018905908,-.0056017507,.050503284,.056105033,.070547044,3.7938731,2.2367616,3.723326
1949,1949,377558,12168,-43,695,652,2543,19991,27813,47854,-181,2724,2163,45691,.2089908,.22386588,1.6429158,-.014875082,-.0035338593,.053583167,.05711703,.17776135,3.9327745,2.2857494,3.7550132
1950,1950,390150,12737,-4,759,755,3048,19962,31140,54384,-59,3107,8424,45960,.23930281,.24393499,1.567245,-.004632174,-.0003140457,.059276126,.059590172,.66138023,4.2697654,2.4448457,3.6083851
1951,1951,404591,14298,32,901,933,3712,20961,30398,53652,-661,4373,4689,48963,.25961673,.30584696,1.4660093,-.046230242,.0022380752,.065253884,.063015804,.32794797,3.752413,2.1260316,3.4244649
1952,1952,410688,15528,123,885,1008,3825,19171,29322,52366,-151,3976,7154,45212,.24632922,.25605357,1.2346084,-.0097243693,.0079211751,.064914994,.056993816,.46071613,3.3723595,1.8883307,2.9116435
1953,1953,433512,16675,122,902,1024,3753,20362,30195,54392,-124,3877,5780,48612,.22506747,.23250374,1.2211094,-.007436282,.0073163416,.061409295,.054092955,.3466267,3.261889,1.8107946,2.9152625
1954,1954,452371,17589,114,965,1079,3908,20835,31846,57276,-99,4007,7022,50254,.22218432,.22781284,1.1845472,-.0056285178,.0064813234,.06134516,.054863837,.39922678,3.2563534,1.8105634,2.8571267
1955,1955,470517,19160,41,1086,1127,4254,25370,31963,61014,-277,4531,5994,55020,.22202505,.23648225,1.3241128,-.014457203,.0021398747,.05882046,.056680586,.31283924,3.1844468,1.668215,2.8716075
1956,1956,478458,20832,25,1220,1245,4684,25463,31225,63538,69,4615,8530,55008,.22484639,.22153418,1.2223022,.0033122119,.0012000768,.059763826,.058563747,.40946621,3.0500193,1.4988959,2.640553
1957,1957,487920,22093,120,1232,1352,4925,24503,32605,64949,81,4844,8749,56200,.22292128,.21925497,1.1090844,.0036663197,.0054315845,.061195854,.055764269,.39600778,2.9398,1.4758068,2.5437922
1958,1958,494469,23210,117,1201,1318,4788,25019,33086,63801,139,4649,7149,56652,.20629039,.20030159,1.0779406,.0059887981,.0050409306,.056785867,.051744938,.3080138,2.7488582,1.4255062,2.4408445
1959,1959,515587,24378,116,1235,1351,4938,25456,33839,65321,-13,4951,5159,60162,.20255968,.20309295,1.0442202,-.00053326768,.0047583887,.055418819,.050660431,.21162523,2.6795061,1.3880959,2.467881
1960,1960,548182,26189,36,1411,1447,5248,28280,36118,68852,-382,5630,1715,67137,.20038947,.21497576,1.0798427,-.014586276,.0013746229,.055252206,.053877581,.065485507,2.6290426,1.3791287,2.5635571
1961,1961,562843,27905,48,1470,1518,5485,28280,36843,70742,-112,5597,4309,66433,.19655976,.20057337,1.0134385,-.0040136175,.0017201218,.054398853,.05267873,.15441677,2.5351012,1.3203011,2.3806844
1962,1962,568897,29224,47,1510,1557,5622,28376,36819,71645,-75,5697,4072,67573,.19237612,.19494252,.97098273,-.0025663837,.0016082672,.053278126,.051669862,.13933752,2.451581,1.2598891,2.3122435
1963,1963,596399,31091,1,1582,1583,5978,27717,36370,74779,-141,6119,4964,69815,.19227429,.19680937,.89147985,-.0045350743,.000032163647,.050915055,.050882891,.15966035,2.4051654,1.1697919,2.2455051
1964,1964,630411,34043,-37,1724,1687,6319,29417,37013,76931,-610,6929,-49,76980,.18561819,.2035367,.86411303,-.017918514,-.0010868608,.049554974,.050641835,-.0014393561,2.2598186,1.0872426,2.2612579
1965,1965,643723,36826,-70,1826,1756,6739,29860,36750,79914,-358,7097,2490,77424,.18299571,.19271711,.81084019,-.0097213928,-.0019008309,.047683701,.049584534,.067615271,2.170043,.99793625,2.1024277
1966,1966,653694,39394,39,1915,1954,7302,30400,39240,83720,-105,7407,4605,79115,.18535818,.18802355,.77169114,-.0026653805,.00098999846,.049601462,.048611462,.11689597,2.1251967,.99609077,2.0083008
1967,1967,671765,41684,151,2060,2211,7540,30623,40705,83904,-495,8035,-520,84424,.18088475,.19275981,.73464638,-.01187506,.003622493,.053041935,.04941944,-.012474811,2.0128586,.97651374,2.0253334
1968,1968,708384,45809,333,2286,2619,9156,30533,44019,93986,-437,9593,3437,90549,.19987339,.20941299,.6665284,-.0095396098,.007269314,.057172172,.049902856,.075028926,2.051693,.96092469,1.9766639
1969,1969,721970,49785,382,2524,2906,10279,33432,47952,102844,99,10180,9529,93315,.20646781,.20447926,.67152756,.0019885509,.0076729939,.058370996,.050698001,.19140303,2.0657628,.96318167,1.8743597
1970,1970,741420,56057,443,3039,3482,11748,33777,51285,107967,349,11399,10380,97587,.2095724,.2033466,.60254741,.0062258057,.0079026707,.062115345,.054212678,.18516867,1.9260217,.91487235,1.7408531
1971,1971,768159,62885,602,3419,4021,13211,35856,55587,115319,722,12489,12801,102518,.21008189,.19860062,.57018369,.011481276,.0095730303,.063942119,.054369088,.20356205,1.8338077,.8839469,1.6302457
1972,1972,801160,70553,703,3673,4376,13963,37366,57743,116506,-126,14089,4376,112130,.19790795,.19969384,.52961606,-.0017858915,.0099641401,.062024295,.052060153,.062024295,1.6513259,.81843436,1.5893017
1973,1973,853211,81746,883,4600,5483,17574,38201,63139,130591,-1793,19367,6483,124108,.214983,.2369168,.46731338,-.021933794,.010801752,.067073621,.056271866,.079306632,1.5975215,.77238029,1.5182149
1974,1974,831823,92612,1255,5764,7019,23565,39363,67872,140013,-4102,27667,14707,125306,.25444868,.29874098,.4250313,-.044292316,.01355116,.075789317,.062238153,.15880232,1.5118235,.73286396,1.3530213
1975,1975,819361,115027,1659,6597,8256,27707,39958,68231,135896,-1719,29426,18869,117027,.24087389,.25581819,.3473793,-.014944318,.014422701,.071774453,.057351753,.16403975,1.181427,.5931738,1.0173873
1976,1976,844053,136901,2811,7970,10781,36185,39928,72389,147878,-1268,37453,25132,122746,.2643151,.27357724,.29165602,-.0092621678,.020533087,.078750335,.058217254,.18357791,1.0801821,.52876896,.89660412
1977,1977,864606,159631,3632,8894,12526,44567,40139,74564,157478,1193,43374,32631,124847,.27918762,.27171415,.25144866,.0074734855,.022752473,.078468464,.055715997,.20441519,.98651266,.46710226,.78209746
1978,1978,900728,185960,4127,9392,13519,48850,40035,74249,159951,2417,46433,30761,129190,.2626909,.24969348,.21528824,.012997419,.022192944,.072698429,.050505485,.1654173,.86013657,.39927405,.69471931
1979,1979,934253,220721,4461,11216,15677,56526,43140,75231,165589,947,55579,24396,141193,.25609708,.25180659,.19545037,.0042904844,.020211035,.071026318,.050815284,.11052868,.75021863,.34084207,.63968992
1980,1980,915042,259663,4275,12698,16973,64466,44668,71943,164693,5398,59068,28515,136178,.24826795,.22747946,.17202297,.020788483,.016463647,.065365493,.048901845,.10981541,.63425672,.27706295,.5244413
1981,1981,908707,289840,4604,14043,18647,69681,45129,71965,163543,7590,62091,31280,132263,.24041195,.21422508,.15570314,.026186861,.015884627,.064335495,.048450869,.10792162,.56425267,.24829216,.45633107
1982,1982,926621,319212,4062,15607,19669,75326,45727,68936,164886,5676,69650,26645,138241,.23597483,.21819355,.14324963,.017781286,.012725086,.06161736,.048892271,.083471172,.51654071,.21595679,.43306956
1983,1983,965509,351051,5175,16780,21955,82939,44317,69248,167727,3283,79656,20989,146738,.23625912,.22690721,.12624092,.0093519175,.014741448,.06254077,.047799323,.059789032,.47778529,.19725908,.41799626
1984,1984,987166,377644,5850,18779,24629,95194,45532,70557,178500,114,95080,17902,160598,.25207338,.25177151,.12056858,.00030187159,.01549078,.06521751,.049726728,.047404435,.47266737,.18683469,.42526296
1985,1985,1027873,414428,8221,19373,27594,105885,45105,74676,188477,4459,101426,24140,164337,.25549674,.24473733,.10883676,.010759409,.019836981,.066583335,.046746358,.058248959,.4547883,.18019053,.39653933
1986,1986,1060255,446635,7854,20828,28682,101679,46631,76754,195920,-2119,103798,20649,175271,.22765569,.23240006,.10440516,-.0047443663,.017584829,.064217985,.046633158,.046232384,.43865797,.1718495,.3924256
1987,1987,1117428,496140,8619,23395,32014,111545,50183,82158,208121,-3494,115039,19296,188825,.22482565,.23186801,.10114685,-.007042367,.017372113,.064526141,.047154028,.038892247,.41948038,.16559438,.38058814
1988,1988,1181481,555607,6976,25791,32767,113478,54455,80320,209915,-15090,128568,-2241,212156,.20424148,.23140097,.098009922,-.027159484,.012555637,.058975138,.046419501,-.0040334263,.37781203,.14456262,.38184544
1989,1989,1211937,614524,6949,29173,36122,128733,56017,81521,219588,-18313,147046,-7654,227242,.20948409,.2392844,.091155104,-.029800301,.011307939,.058780454,.047472514,-.012455168,.35733023,.13265714,.3697854
1990,1990,1220831,668931,8201,31476,39677,141990,56915,83569,231070,-11135,153125,2916,228154,.21226405,.22891001,.085083514,-.016645962,.01225986,.059314039,.047054179,.0043591941,.34543175,.12492917,.34107256
1991,1991,1207364,705464,8393,32429,40822,144761,55986,80776,230702,-2608,147369,12838,217864,.2051997,.20889656,.079360537,-.0036968577,.011897135,.057865463,.045968328,.018197952,.32702166,.11450053,.3088237
1992,1992,1212206,730578,8972,35649,44621,152484,59573,88089,240675,-4897,157381,8535,232140,.20871693,.21541984,.081542283,-.006702912,.012280688,.061076298,.048795611,.011682531,.32943094,.12057439,.31774843
1993,1993,1242396,769159,11276,40435,51711,173940,59939,92835,250928,-2703,176643,11657,239271,.22614309,.22965732,.077927969,-.0035142279,.014660168,.067230575,.052570406,.015155514,.32623684,.12069676,.31108132
1994,1994,1290179,809486,11854,45366,57220,192363,65986,98820,273243,-240,192603,20282,252961,.23763599,.23793246,.081515923,-.00029648445,.01464386,.070686832,.056042969,.025055405,.33755124,.12207747,.31249583
1995,1995,1322839,850181,15436,48247,63683,217260,67537,106013,298078,2317,214943,31772,266306,.25554559,.25282028,.079438381,.002725302,.018156134,.074905224,.056749091,.037370864,.35060534,.12469462,.31323448
1996,1996,1355798,907265,16420,53635,70055,237251,73092,112146,319235,1525,235726,28454,290781,.26150131,.25982046,.080563009,.001680876,.018098351,.07721559,.059117235,.031362392,.35186523,.12360886,.32050282
1997,1997,1423254,951750,18017,55036,73053,243306,81383,121543,358485,4257,239049,39423,319062,.25564066,.25116783,.085508801,.0044728131,.01893039,.0767565,.057826109,.041421592,.3766588,.12770475,.33523721
1998,1998,1476025,997247,17348,59262,76610,240834,88200,130173,367993,-6746,247580,24986,343007,.24149884,.24826346,.088443488,-.0067646229,.017395891,.076821491,.0594256,.025054976,.36900887,.13053235,.34395391
1999,1999,1524662,1039752,16287,65842,82129,248866,98438,134949,378295,-14907,263773,10634,367661,.2393513,.25368837,.094674498,-.014337073,.015664313,.078989029,.063324712,.010227439,.36383197,.12978961,.35360453
2000,2000,1578121,1095900,18379,70274,88653,276134,103802,144864,412086,-19554,295688,9820,402266,.25197008,.26981294,.094718494,-.017842868,.016770691,.080895156,.064124465,.0089606717,.37602517,.13218725,.36706451
2001,2001,1621208,1138375,20603,75133,95736,286801,107574,148371,421103,-25914,312715,-5927,427030,.25193894,.27470297,.094497859,-.022764027,.018098606,.084098823,.066000223,-.0052065444,.3699159,.13033579,.37512243
2002,2002,1656531,1187671,19900,79992,99892,287720,114388,152008,425656,-31921,319641,-23879,449535,.24225564,.26913261,.096312866,-.026876971,.016755482,.084107466,.067351982,-.020105736,.35839555,.12798831,.3785013
2003,2003,1711559,1256188,25624,86355,111979,300545,119906,165832,435568,-28112,328657,-22356,457924,.23925161,.26163042,.095452271,-.022378815,.02039822,.089141913,.068743691,-.017796699,.34673792,.13201208,.36453462
2004,2004,1750690,1317459,29737,92064,121801,313481,129138,183109,455853,-33794,347275,-30553,486406,.23794365,.26359454,.098020509,-.025650892,.02257148,.092451453,.069879971,-.023190854,.34600925,.13898648,.36920011
2005,2005,1802435,1393038,36062,99801,135863,349105,136011,196731,491838,-33950,383055,-28179,520017,.25060695,.27497813,.097636245,-.024371194,.025887305,.09753,.071642697,-.020228451,.35306862,.14122443,.37329707
2006,2006,1850989,1470719,47523,107174,154697,401162,142293,216366,554409,-31242,432404,-19305,573714,.2727659,.29400858,.096750639,-.021242671,.032312766,.10518461,.072871841,-.013126233,.3769646,.1471158,.39009082
2007,2007,1894682,1546085,57530,110891,168421,392109,144387,237713,543251,-31597,423706,-12540,555791,.25361413,.27405092,.093388788,-.020436781,.037210114,.10893386,.071723744,-.0081108091,.351372,.15375157,.35948282
2008,2008,1889401,1589259,56022,120910,176932,429839,143591,239213,545380,-34688,464527,2680,542700,.27046505,.29229155,.090350911,-.021826524,.035250392,.11132987,.07607948,.0016863205,.34316623,.15051858,.3414799
2009,2009,1811672,1548513,60189,120889,181078,408751,135977,227469,499635,-24871,433622,402,499233,.26396355,.28002477,.087811336,-.016061215,.0388689,.1169367,.078067794,.0002596039,.32265469,.14689513,.32239509
2010,2010,1849247,1606027,64256,123179,187435,453703,136267,227634,528730,-31123,484826,-10049,538779,.28250024,.30187911,.084847264,-.019378876,.04000929,.11670725,.07669796,-.0062570553,.32921612,.14173734,.33547318
2011,2011,1872838,1660141,81423,126670,208093,509890,137670,246226,566927,-15837,525727,19355,547572,.30713657,.31667611,.082926691,-.0095395511,.049045835,.12534659,.076300748,.011658648,.34149328,.14831632,.32983464
2012,2012,1899626,1711770,85235,129680,214915,513317,142068,252449,570563,-21190,534507,12297,558266,.29987499,.31225398,.082994796,-.012379,.049793489,.12555133,.075757839,.0071837921,.33331755,.14747834,.32613376
2013,2013,1941155,1780336,93990,137890,231880,531790,146281,259734,575443,-25006,556796,-1,575444,.29870203,.31274772,.082164824,-.014045663,.052793406,.13024507,.077451669,-5.6169171e-07,.32322156,.14589044,.32322213
2014,2014,1996725,1863008,92019,144252,236271,525324,155930,259774,576799,-28933,554257,-17918,594717,.28197625,.29750651,.083697975,-.01553026,.049392704,.12682232,.077429622,-.0096177794,.30960628,.13943794,.31922406
2015,2015,2043909,1919641,87850,153827,241677,523366,170836,264548,592946,-28272,551638,-33955,626901,.27263743,.2873652,.088993721,-.014727754,.045763765,.12589698,.080133215,-.017688204,.30888379,.13781118,.326572
2016,2016,2079113,1994712,96719,168974,265693,563248,176142,280523,609198,-36113,599361,-42445,651643,.2823706,.30047494,.088304475,-.018104369,.048487701,.13319868,.084710978,-.021278761,.30540648,.14063333,.32668525
2017,2017,2115296,2068757,105496,181164,286660,622868,182463,292507,642143,-29889,652757,-26754,668897,.30108321,.31553102,.08819934,-.014447806,.050994873,.1385663,.087571427,-.012932403,.3104004,.14139263,.32333282
2018,2018,2141792,2141792,111356,199113,310469,661601,199113,310469,661601,-25487,687088,-25487,687088,.30890068,.32080051,.09296561,-.011899848,.051991977,.14495759,.09296561,-.011899848,.30890068,.14495759,.32080051
2019,2019,2172511,2218439,103333,212987,316320,689274,207408,311838,679186,-27470,716744,-26686,705872,.31070226,.32308483,.093492769,-.012382581,.046579149,.14258675,.0960076,-.012029179,.30615491,.14056641,.31818408
1955-1-15,1955 Q1,116532,4664,14,260,274,1073,6504,8826,15834,-83,1156,1773,14061,.23006004,.24785592,1.3945111,-.017795883,.0030017153,.058747854,.055746142,.38014579,3.3949399,1.8923671,3.0147941
1955-4-15,1955 Q2,116637,4687,27,267,294,994,6230,8281,14170,-68,1062,1201,12969,.21207595,.22658417,1.3292085,-.014508214,.0057606143,.062726691,.056966078,.25624067,3.0232558,1.7668018,2.7670152
1955-7-15,1955 Q3,118997,4860,-7,298,291,1077,6298,7690,15160,-92,1169,1195,13965,.22160494,.24053498,1.2958847,-.01893004,-.0014403292,.059876543,.061316874,.24588478,3.1193416,1.5823045,2.8734567
1955-10-15,1955 Q4,118351,4949,7,261,268,1110,6338,7166,15850,-34,1144,1825,14025,.22428773,.23115781,1.2806628,-.0068700747,.0014144272,.054152355,.052737925,.36876136,3.2026672,1.4479693,2.8339059
1956-1-15,1956 Q1,119735,5083,8,296,304,1154,6557,7890,15866,-5,1159,1707,14159,.22703128,.22801495,1.2899863,-.00098367105,.0015738737,.0598072,.058233328,.33582529,3.1213851,1.552233,2.7855597
1956-4-15,1956 Q2,119475,5152,22,299,321,1204,6270,7686,16138,42,1162,2258,13880,.23369566,.22554348,1.2170031,.0081521738,.0042701862,.062305901,.058035713,.43827641,3.1323757,1.4918479,2.6940994
1956-7-15,1956 Q3,119357,5233,-8,331,323,1124,6333,7827,15060,-27,1151,1679,13381,.21479075,.21995032,1.2102045,-.0051595643,-.0015287598,.061723676,.063252434,.32084846,2.8778903,1.4957004,2.5570419
1956-10-15,1956 Q4,119891,5364,3,294,297,1202,6303,7822,16474,59,1143,2886,13588,.22408651,.21308725,1.175056,.010999254,.00055928412,.055369128,.054809842,.53803134,3.0712156,1.4582402,2.5331843
1957-1-15,1957 Q1,122290,5376,40,297,337,1244,6215,8421,16619,2,1242,2209,14410,.23139881,.23102678,1.156064,.00037202382,.0074404762,.062686011,.055245537,.41090029,3.091332,1.5664063,2.6804316
1957-4-15,1957 Q2,122303,5458,49,304,353,1259,6066,8198,16453,39,1220,2627,13826,.23067057,.22352511,1.1113961,.0071454747,.0089776479,.064675704,.055698059,.48131183,3.0144742,1.5020154,2.5331624
1957-7-15,1957 Q3,121553,5575,8,342,350,1205,6350,8108,15652,-21,1226,1575,14077,.2161435,.21991031,1.1390134,-.0037668161,.0014349776,.062780268,.06134529,.2825112,2.8075337,1.4543498,2.5250225
1957-10-15,1957 Q4,121774,5684,23,289,312,1217,5872,7878,16225,61,1156,2338,13887,.21410978,.2033779,1.0330753,.010731879,.0040464462,.054890923,.050844476,.41133004,2.8545039,1.3859957,2.4431739
1958-1-15,1958 Q1,124411,5797,52,267,319,1215,6071,8279,16256,80,1135,2322,13934,.20959117,.19579093,1.0472658,.013800241,.0089701572,.055028465,.046058305,.400552,2.804209,1.4281524,2.403657
1958-4-15,1958 Q2,121520,5722,30,302,332,1170,6260,8274,15549,46,1124,1766,13783,.20447396,.19643481,1.0940231,.0080391476,.0052429219,.058021672,.052778747,.30863336,2.7174065,1.445998,2.4087732
1958-7-15,1958 Q3,124197,5822,5,348,353,1203,6340,8220,15735,-3,1206,1615,14120,.20663002,.2071453,1.0889728,-.00051528687,.00085881143,.060632084,.059773274,.27739608,2.7026794,1.411886,2.4252834
1958-10-15,1958 Q4,124341,5869,30,284,314,1200,6348,8313,16261,16,1184,1446,14815,.20446414,.20173794,1.0816152,.0027261884,.0051116035,.05350145,.048389845,.24637929,2.7706594,1.4164252,2.5242801
1959-1-15,1959 Q1,125143,5883,55,266,321,1183,5940,8319,15859,30,1153,1507,14352,.20108788,.19598845,1.009689,.0050994391,.0093489718,.054563999,.045215026,.25616181,2.6957335,1.4140744,2.4395716
1959-4-15,1959 Q2,127218,6078,22,317,339,1246,6512,8337,16376,17,1229,1146,15230,.20500165,.20220467,1.0714051,.0027969726,.0036196117,.055774927,.052155316,.18854886,2.6943073,1.3716683,2.5057585
1959-7-15,1959 Q3,129949,6100,8,358,366,1216,6476,8518,15843,-51,1267,1098,14745,.19934426,.20770492,1.0616393,-.008360656,.0013114754,.059999999,.058688525,.18000001,2.597213,1.3963934,2.4172132
1959-10-15,1959 Q4,133277,6317,31,294,325,1293,6528,8665,17243,-9,1302,1408,15835,.20468576,.20611049,1.033402,-.0014247269,.0049073929,.051448472,.04654108,.22289062,2.7296185,1.3716954,2.5067279
1960-1-15,1960 Q1,136599,6421,11,324,335,1320,6991,8709,17458,-60,1380,792,16666,.20557545,.21491979,1.0887712,-.0093443384,.0017131288,.05217256,.05045943,.12334527,2.7188911,1.3563308,2.5955458
1960-4-15,1960 Q2,135553,6482,9,347,356,1317,6976,8907,17275,-87,1404,349,16926,.20317803,.21659982,1.0762111,-.013421783,.0013884604,.054921322,.053532861,.053841408,2.6650724,1.374113,2.6112311
1960-7-15,1960 Q3,137604,6576,-8,410,402,1285,7136,9102,16431,-158,1443,-49,16480,.19540754,.21943431,1.0851581,-.024026765,-.001216545,.061131388,.062347934,-.0074513382,2.4986315,1.384124,2.5060828
1960-10-15,1960 Q4,138426,6710,24,330,354,1326,7177,9400,17688,-77,1403,623,17065,.1976155,.2090909,1.0695976,-.011475409,.0035767511,.052757081,.049180329,.092846498,2.6360655,1.4008942,2.5432191
1961-1-15,1961 Q1,140702,6878,27,341,368,1382,7135,9447,18147,-42,1424,866,17281,.20093051,.20703693,1.0373656,-.0061064265,.0039255596,.053503927,.049578365,.12590869,2.6384122,1.3735098,2.5125036
1961-4-15,1961 Q2,141275,6878,10,368,378,1383,7093,9172,17791,-43,1426,964,16827,.2010759,.20732771,1.0312591,-.0062518176,.0014539111,.054957837,.053503927,.14015703,2.586653,1.3335272,2.446496
1961-7-15,1961 Q3,140555,7114,-16,428,412,1350,7082,8969,16858,-51,1401,832,16026,.18976666,.19693562,.99550182,-.0071689626,-.0022490863,.057913974,.060163058,.11695249,2.3696935,1.2607534,2.2527411
1961-10-15,1961 Q4,140311,7035,27,333,360,1370,6970,9255,17946,24,1346,1647,16299,.19474058,.19132906,.99076051,.0034115138,.0038379531,.051172707,.047334753,.23411514,2.5509596,1.315565,2.3168445
1962-1-15,1962 Q1,140941,7130,24,345,369,1371,7236,9415,17802,-30,1401,757,17045,.19228612,.19649369,1.0148667,-.0042075738,.0033660589,.051753156,.048387095,.10617111,2.4967742,1.3204769,2.3906031
1962-4-15,1962 Q2,142246,7304,4,383,387,1441,7175,9070,18381,13,1428,1468,16913,.19728915,.19550931,.98233843,.0017798466,.00054764515,.052984666,.052437022,.20098576,2.5165663,1.2417853,2.3155806
1962-7-15,1962 Q3,143137,7378,-12,436,424,1385,6840,8990,17127,-76,1461,581,16546,.18772025,.19802114,.92708051,-.010300894,-.0016264571,.05746815,.059094604,.07874763,2.3213608,1.2184874,2.2426131
1962-10-15,1962 Q4,142573,7412,31,346,377,1425,7125,9344,18335,18,1407,1266,17069,.1922558,.18982731,.96127903,.0024284944,.0041824067,.050863463,.046681058,.1708041,2.4736912,1.2606584,2.3028872
1963-1-15,1963 Q1,143171,7363,26,342,368,1454,6738,9261,18688,23,1431,1927,16761,.19747385,.19435012,.91511613,.0031237267,.0035311694,.049979627,.046448458,.26171398,2.538096,1.2577753,2.276382
1963-4-15,1963 Q2,149459,7748,-1,392,391,1505,6889,8912,18913,-5,1510,1546,17367,.19424367,.19488901,.88913268,-.00064532785,-.00012906556,.050464638,.0505937,.19953537,2.4410172,1.1502323,2.2414818
1963-7-15,1963 Q3,150182,7868,-39,476,437,1484,7059,9045,17903,-118,1602,384,17519,.1886121,.20360956,.89717847,-.014997458,-.004956787,.055541433,.060498219,.048805289,2.2754195,1.1495932,2.2266142
1963-10-15,1963 Q4,153587,8112,15,372,387,1535,7031,9152,19275,-41,1576,1107,18168,.18922584,.19428007,.86674064,-.0050542406,.0018491125,.047707099,.045857988,.13646449,2.3761094,1.1282052,2.239645
1964-1-15,1964 Q1,154560,8143,3,384,387,1555,7390,9260,19473,-131,1686,429,19044,.19096155,.207049,.90752792,-.016087437,.00036841459,.04752548,.047157068,.052683286,2.3913791,1.1371731,2.3386958
1964-4-15,1964 Q2,157401,8432,-13,431,418,1606,7389,9067,19599,-125,1731,318,19281,.1904649,.20528938,.87630457,-.014824478,-.0015417457,.049573056,.051114801,.037713472,2.3243597,1.0753083,2.2866461
1964-7-15,1964 Q3,158019,8616,-47,513,466,1539,7348,9233,18026,-235,1774,-958,18984,.17862117,.20589601,.85283196,-.027274838,-.0054549677,.054085422,.059540391,-.11118849,2.092154,1.0716109,2.2033427
1964-10-15,1964 Q4,160431,8852,20,396,416,1619,7290,9453,19833,-119,1738,162,19671,.18289652,.19633982,.82354271,-.013443289,.0022593765,.046995029,.044735651,.018300949,2.2405107,1.0678942,2.2222097
1965-1-15,1965 Q1,159955,9018,7,397,404,1593,6623,8682,19049,-86,1679,852,18197,.17664671,.18618318,.73442006,-.0095364824,.00077622535,.044799291,.044023067,.094477713,2.1123309,.9627412,2.0178533
1965-4-15,1965 Q2,160049,9062,-10,460,450,1710,7529,9450,20393,-72,1782,905,19488,.18870007,.19664533,.83083206,-.0079452656,-.0011035091,.049657911,.05076142,.099867582,2.2503862,1.0428162,2.1505187
1965-7-15,1965 Q3,161365,9283,-72,550,478,1681,8924,9798,19786,-172,1853,-524,20310,.18108369,.1996122,.96132714,-.018528493,-.0077561135,.051491976,.059248086,-.056447268,2.131423,1.0554777,2.1878703
1965-10-15,1965 Q4,162354,9463,5,419,424,1755,6784,8820,20686,-28,1783,1257,19429,.18545915,.18841805,.71689737,-.0029588926,.00052837364,.044806086,.044277713,.13283314,2.1859875,.93205112,2.0531545
1966-1-15,1966 Q1,162611,9606,11,425,436,1784,6970,8913,20680,-61,1845,721,19959,.18571725,.19206746,.7255882,-.0063501978,.0011451177,.0453883,.044243183,.075057253,2.1528211,.92785758,2.0777638
1966-4-15,1966 Q2,163584,9774,8,480,488,1762,7730,9859,20246,-89,1851,445,19801,.1802742,.18937999,.79087377,-.0091057913,.00081849808,.049928382,.049109884,.045528956,2.071414,1.0086966,2.0258851
1966-7-15,1966 Q3,164093,9956,-34,584,550,1820,9109,10935,20749,-146,1966,-173,20922,.18280435,.19746886,.91492569,-.014664524,-.003415026,.055243071,.058658097,-.017376456,2.08407,1.0983326,2.1014464
1966-10-15,1966 Q4,163406,10058,54,426,480,1936,6591,9533,22045,191,1745,3612,18433,.19248359,.17349374,.65529925,.018989859,.0053688604,.047723204,.042354345,.35911712,2.1917877,.94780272,1.8326706
1967-1-15,1967 Q1,165604,10160,61,422,483,1894,6307,9226,21456,-26,1920,1218,20238,.18641733,.18897638,.62076771,-.0025590551,.0060039372,.047539368,.041535433,.11988189,2.1118109,.90807086,1.9919292
1967-4-15,1967 Q2,167950,10415,31,487,518,1929,7193,9599,21617,-70,1999,352,21265,.18521364,.1919347,.69063848,-.0067210752,.0029764762,.049735956,.046759482,.033797409,2.0755641,.92165148,2.0417666
1967-7-15,1967 Q3,168685,10487,14,613,627,1888,9014,11459,20960,-134,2022,-350,21310,.18003242,.19281015,.8595404,-.012777725,.0013349862,.059788309,.058453321,-.033374656,1.998665,1.0926862,2.0320396
1967-10-15,1967 Q4,169526,10622,45,538,583,1829,8109,10421,19871,-265,2094,-1740,21611,.1721898,.19713801,.76341558,-.024948221,.0042364905,.054886084,.050649595,-.16381095,1.8707399,.98107702,2.0345509
1968-1-15,1968 Q1,175742,11101,43,525,568,2177,7197,9717,22732,-185,2362,-37,22769,.19610846,.21277362,.64831996,-.016665164,.003873525,.051166561,.047293037,-.0033330331,2.0477436,.87532657,2.0510764
1968-4-15,1968 Q2,175014,11234,87,556,643,2234,7295,10758,23057,-125,2359,771,22286,.1988606,.20998754,.64936799,-.011126936,.0077443477,.057236958,.049492612,.068630941,2.0524302,.95762861,1.9837992
1968-7-15,1968 Q3,178468,11589,91,663,754,2351,8778,12584,23921,-120,2471,763,23158,.20286478,.21321943,.75744241,-.010354646,.007852274,.065061696,.057209421,.065838292,2.0641124,1.0858573,1.9982742
1968-10-15,1968 Q4,179160,11885,112,542,654,2394,7263,10960,24276,-7,2401,1940,22336,.20143038,.20201935,.61110646,-.00058897771,.0094236434,.055027347,.045603704,.16323097,2.0425746,.92217082,1.8793437
1969-1-15,1969 Q1,178747,12092,87,571,658,2353,8019,10912,23634,-124,2477,404,23230,.19459146,.20484617,.66316575,-.010254714,.0071948394,.054416142,.047221303,.033410519,1.9545153,.9024148,1.9211049
1969-4-15,1969 Q2,180122,12274,99,615,714,2598,8170,11897,26184,56,2542,2805,23379,.21166694,.20710444,.66563469,.0045624897,.00806583,.058171745,.050105914,.22853185,2.1332898,.96928465,1.904758
1969-7-15,1969 Q3,181119,12545,104,724,828,2649,9312,13609,26439,73,2576,2927,23512,.21115983,.20534077,.74228776,.0058190515,.0082901558,.066002391,.057712235,.23332004,2.107533,1.0848147,1.8742129
1969-10-15,1969 Q4,181982,12874,92,614,706,2679,7931,11534,26587,94,2585,3393,23194,.20809384,.2007923,.61604786,.0073015378,.0071461862,.054839212,.047693025,.26355445,2.06517,.89591426,1.8016157
1970-1-15,1970 Q1,180827,13228,140,613,753,2746,7146,11343,25762,149,2597,3078,22684,.20758995,.19632597,.5402177,.011263985,.01058361,.056924704,.046341095,.23268823,1.9475355,.85749924,1.7148473
1970-4-15,1970 Q2,185094,13806,112,717,829,2932,8068,12226,27147,37,2895,2233,24914,.21237144,.20969144,.58438361,.0026799941,.0081124147,.060046356,.051933941,.16174127,1.966319,.885557,1.8045777
1970-7-15,1970 Q3,186934,14258,100,902,1002,2888,9881,14616,26236,-19,2907,1631,24605,.20255296,.20388554,.69301444,-.0013325852,.0070136064,.070276335,.063262731,.11439192,1.8400898,1.0251087,1.7256979
1970-10-15,1970 Q4,188565,14765,91,807,898,3182,8682,13100,28822,182,3000,3438,25384,.21550965,.2031832,.58801222,.012326447,.0061632236,.060819507,.054656282,.23284794,1.9520488,.88723332,1.7192008
1971-1-15,1971 Q1,187635,14992,126,772,898,2965,8054,12562,26358,-56,3021,1182,25176,.19777215,.20150746,.53721982,-.0037353255,.0084044822,.059898611,.051494129,.078842051,1.7581377,.83791357,1.6792957
1971-4-15,1971 Q2,190988,15499,133,858,991,3397,9045,13648,29861,223,3174,3910,25951,.21917543,.2047874,.58358604,.014388025,.0085811988,.063939609,.05535841,.25227433,1.9266404,.88057292,1.6743661
1971-7-15,1971 Q3,194393,15996,152,974,1126,3423,10147,15345,29515,277,3146,3877,25638,.213991,.19667417,.63434607,.017316829,.0095023755,.070392601,.060890224,.24237309,1.8451488,.95930231,1.6027757
1971-10-15,1971 Q4,195143,16398,191,815,1006,3426,8610,14032,29585,278,3148,3832,25753,.20892791,.19197462,.52506405,.016953288,.011647762,.061348945,.049701184,.23368703,1.8041835,.85571408,1.5704964
1972-1-15,1972 Q1,195374,16596,164,822,986,3274,8638,13381,28047,-72,3346,699,27348,.19727646,.20161484,.52048689,-.0043383949,.0098818997,.059411906,.049530007,.042118583,1.6899855,.80627865,1.647867
1972-4-15,1972 Q2,200521,17383,189,864,1053,3531,9233,14193,29889,119,3412,1815,28074,.2031295,.19628373,.53115112,.006845769,.010872692,.060576424,.049703732,.10441235,1.7194386,.81648737,1.6150261
1972-7-15,1972 Q3,201060,17753,148,1056,1204,3223,10432,15727,26615,-213,3436,-332,26947,.18154678,.19354476,.58761901,-.011997973,.0083366195,.067819521,.059482906,-.018701065,1.4991832,.88587844,1.5178843
1972-10-15,1972 Q4,204205,18821,202,931,1133,3935,9063,14442,31955,40,3895,2194,29761,.20907497,.20694968,.48153657,.0021252856,.010732693,.060198713,.049466021,.11657191,1.6978375,.76733434,1.5812656
1973-1-15,1973 Q1,214333,20040,170,961,1131,3886,8581,14345,30860,-425,4311,87,30773,.19391218,.21511976,.4281936,-.021207584,.0084830336,.056437127,.047954094,.0043413173,1.5399202,.71581835,1.5355788
1973-4-15,1973 Q2,214628,19862,205,1094,1299,4295,9443,15683,32869,-247,4542,2165,30704,.21624207,.22867788,.47543046,-.012435807,.010321217,.065401271,.055080052,.10900211,1.6548686,.78959823,1.5458665
1973-7-15,1973 Q3,212585,20547,237,1331,1568,4530,10995,17708,33207,-442,4972,2048,31159,.22047015,.2419818,.53511459,-.021511655,.011534531,.076312847,.064778313,.099673919,1.6161484,.86182898,1.5164744
1973-10-15,1973 Q4,211665,21297,271,1214,1485,4863,9182,15403,33655,-679,5542,2183,31472,.22834203,.26022443,.43114054,-.031882424,.012724797,.069728129,.057003334,.1025027,1.5802696,.72324741,1.4777669
1974-1-15,1974 Q1,205849,21119,233,1286,1519,5147,8754,15199,33227,-1130,6277,2465,30762,.24371418,.2972205,.41450825,-.053506322,.011032719,.071925752,.060893036,.11671954,1.5733227,.71968371,1.4566031
1974-4-15,1974 Q2,208808,22634,266,1437,1703,5936,9886,16629,35677,-1160,7096,3599,32078,.26226032,.31351066,.43677652,-.051250331,.011752231,.075240791,.063488558,.15900858,1.576257,.73469114,1.4172484
1974-7-15,1974 Q3,210128,23880,414,1609,2023,6220,11099,19206,36068,-883,7103,4487,31581,.26046902,.29744557,.46478224,-.03697655,.017336683,.08471524,.067378558,.18789782,1.5103853,.80427134,1.3224875
1974-10-15,1974 Q4,207038,24979,342,1432,1774,6262,9624,16838,35041,-929,7191,4156,30885,.25069058,.28788182,.38528365,-.037191242,.013691501,.071019657,.057328157,.16637976,1.4028183,.67408621,1.2364386
1975-1-15,1975 Q1,207156,26799,368,1418,1786,6307,9247,16037,32820,-648,6955,3976,28844,.2353446,.25952461,.34505019,-.024180006,.013731856,.066644281,.052912422,.14836374,1.2246726,.59841788,1.0763088
1975-4-15,1975 Q2,203755,28112,358,1605,1963,6819,9867,16459,34190,-354,7173,4936,29254,.24256545,.25515795,.35098889,-.012592487,.012734775,.069827832,.057093058,.17558338,1.2162066,.5854795,1.0406232
1975-7-15,1975 Q3,203060,29242,463,1895,2358,7034,11189,18932,33880,-557,7591,4019,29861,.24054442,.25959235,.38263458,-.019047944,.015833391,.08063744,.064804047,.1374393,1.1586075,.64742494,1.0211682
1975-10-15,1975 Q4,205390,30874,470,1679,2149,7547,9655,16803,35006,-160,7707,5938,29068,.24444516,.24962752,.31272268,-.0051823542,.015223165,.069605492,.054382328,.19233012,1.1338342,.54424435,.94150418
1976-1-15,1976 Q1,208792,32430,624,1559,2183,7868,8722,15742,34793,-85,7953,5972,28821,.24261487,.24523589,.2689485,-.00262103,.019241443,.067314215,.048072774,.18415047,1.0728647,.48541474,.88871413
1976-4-15,1976 Q2,208498,33299,558,1961,2519,8824,9975,17047,36987,-520,9344,5593,31394,.26499295,.28060904,.29955855,-.015616084,.016757259,.07564792,.058890656,.167963,1.1107541,.51193732,.9427911
1976-7-15,1976 Q3,211146,34523,865,2323,3188,9406,11373,21153,37726,-339,9745,6427,31299,.27245605,.28227559,.32943255,-.0098195402,.025055761,.092344232,.067288473,.18616575,1.0927787,.61272198,.90661299
1976-10-15,1976 Q4,215617,36649,764,2127,2891,10087,9858,18447,38372,-324,10411,7140,31232,.27523261,.28407323,.26898414,-.0088406233,.020846408,.078883462,.058037054,.19482113,1.0470135,.50334251,.8521924
1977-1-15,1977 Q1,215667,38007,739,1929,2668,10230,8913,16190,37387,-384,10614,6370,31017,.26916096,.27926436,.23450944,-.010103402,.019443786,.070197597,.05075381,.16760071,.98368722,.42597416,.81608653
1977-4-15,1977 Q2,214117,39205,813,2186,2999,11069,9750,17757,39229,-143,11212,7008,32221,.28233644,.28598392,.24869277,-.0036474939,.020737151,.076495342,.055758193,.17875271,1.0006121,.45292693,.82185948
1977-7-15,1977 Q3,215574,40298,1145,2593,3738,11950,11453,22091,41743,968,10982,10500,31243,.29654077,.27251974,.28420764,.024021043,.02841332,.092758946,.064345628,.26055884,1.0358579,.54819095,.77529901
1977-10-15,1977 Q4,219248,42121,935,2186,3121,11318,10023,18526,39119,752,10566,8753,30366,.26870206,.25084874,.23795731,.017853327,.022197954,.074096054,.051898103,.20780608,.92872912,.43982813,.72092307
1978-1-15,1978 Q1,221203,44092,903,2036,2939,11215,9096,16846,37940,166,11049,5722,32218,.25435454,.25058967,.20629592,.0037648552,.020479906,.066656083,.046176177,.12977411,.86047357,.38206476,.73069942
1978-4-15,1978 Q2,223770,45856,781,2386,3167,12366,10196,17294,40828,545,11821,6889,33939,.26967028,.25778523,.22234821,.011885031,.017031576,.069064029,.052032448,.15023115,.89035243,.37713712,.74012125
1978-7-15,1978 Q3,226852,47154,1286,2744,4030,12602,11430,22065,41018,776,11826,8485,32533,.26725197,.25079527,.24239725,.016456716,.027272342,.085464649,.058192305,.17994231,.86987317,.46793485,.68993086
1978-10-15,1978 Q4,228903,48858,1157,2226,3383,12667,9313,18044,40165,930,11737,9665,30500,.25926152,.24022678,.19061361,.019034754,.023680871,.069241472,.045560606,.19781816,.8220762,.36931515,.62425804
1979-1-15,1979 Q1,228088,50402,997,2332,3329,11834,9354,16711,36351,-689,12523,3379,32972,.23479228,.24846236,.18558787,-.013670092,.019780962,.066048965,.046268005,.067040987,.72122139,.33155429,.65418041
1979-4-15,1979 Q2,238126,53904,873,2802,3675,14532,10982,18114,43504,248,14284,7480,36024,.26959038,.26498961,.20373257,.0046007717,.016195459,.068176761,.0519813,.13876522,.80706441,.33604184,.6682992
1979-7-15,1979 Q3,232811,56698,1309,3282,4591,14698,12458,22161,42870,751,13947,6654,36216,.25923312,.24598752,.21972556,.013245617,.023087233,.080972873,.057885639,.11735864,.75611132,.39086035,.6387527
1979-10-15,1979 Q4,235228,59717,1282,2800,4082,15462,10346,18245,42864,637,14825,6883,35981,.25892124,.24825427,.1732505,.010666979,.021467924,.068355747,.046887822,.11526031,.71778554,.30552438,.60252523
1980-1-15,1980 Q1,232982,62025,1043,2789,3832,15839,9981,16802,42073,317,15522,5604,36469,.25536478,.25025392,.16091898,.0051108422,.0168158,.061781541,.04496574,.090350665,.67832327,.27089077,.58797258
1980-4-15,1980 Q2,228337,63624,812,3263,4075,16021,11426,17518,40920,443,15578,5279,35641,.25180748,.24484472,.17958632,.0069627813,.012762479,.064048156,.051285677,.082971834,.64315355,.27533635,.56018168
1980-7-15,1980 Q3,228108,65948,1128,3777,4905,16357,13088,20776,41187,1931,14426,8130,33057,.24802876,.21874811,.19845939,.029280646,.017104385,.074376784,.057272397,.12327895,.62453753,.31503609,.50125855
1980-10-15,1980 Q4,225615,68066,1292,2869,4161,16249,10173,16847,40513,2707,13542,9502,31011,.23872417,.19895396,.14945787,.039770223,.018981576,.061131842,.042150266,.1395998,.59520173,.24750976,.45560193
1981-1-15,1981 Q1,225484,69863,1284,2706,3990,15773,9307,15985,38591,2683,13090,8878,29713,.22577044,.18736671,.13321787,.038403735,.018378828,.057111777,.03873295,.12707728,.5523811,.22880495,.42530382
1981-4-15,1981 Q2,226006,71249,913,3504,4417,16773,11551,17073,40014,1939,14834,7476,32538,.23541383,.20819941,.16212158,.027214417,.012814215,.061993852,.049179636,.10492779,.5616079,.23962441,.45668009
1981-7-15,1981 Q3,228469,73221,1223,4267,5490,18266,13718,21072,42289,1012,17254,6356,35933,.24946395,.23564278,.18735063,.013821172,.016702859,.074978493,.058275633,.086805701,.57755291,.2877863,.49074718
1981-10-15,1981 Q4,228748,75507,1184,3566,4750,18869,10553,17835,42649,1956,16913,8570,34079,.24989736,.22399248,.13976188,.025904883,.015680665,.062908076,.047227409,.11349941,.56483507,.23620327,.45133564
1982-1-15,1982 Q1,229165,77381,1344,3129,4473,17764,9806,16240,39753,1247,16517,6223,33530,.2295654,.21345033,.12672362,.016115068,.017368605,.057804886,.040436283,.080420256,.51373076,.20987064,.43331051
1982-4-15,1982 Q2,231570,78901,766,4034,4800,18636,11907,17000,41429,592,18044,5446,35983,.23619473,.22869165,.15091063,.0075030737,.0097083692,.06083573,.051127363,.069023207,.52507573,.21545988,.45605251
1982-7-15,1982 Q3,232134,80348,779,4765,5544,19075,13770,19299,41348,1243,17832,6177,35171,.23740479,.22193459,.17137951,.015470205,.009695325,.068999849,.059304524,.076878078,.51461142,.24019267,.43773335
1982-10-15,1982 Q4,233752,82582,1173,3679,4852,19851,10244,16397,42356,2594,17257,8799,33557,.24037926,.20896806,.1240464,.031411204,.014204063,.058753725,.044549659,.10654864,.5128963,.19855416,.40634763
1983-1-15,1983 Q1,238082,85542,1476,3490,4966,19686,9110,16108,40707,968,18718,5722,34985,.23013256,.21881649,.10649739,.011316079,.017254682,.058053356,.040798672,.066891119,.4758715,.18830515,.40898037
1983-4-15,1983 Q2,240053,86316,1081,4174,5255,20073,11120,16773,40975,64,20009,3977,36998,.23255248,.23181102,.12882896,.00074146158,.01252375,.060880948,.0483572,.046074886,.47470921,.19432087,.42863432
1983-7-15,1983 Q3,242654,88459,1185,5169,6354,21198,13760,19902,42368,778,20420,4770,37598,.23963644,.23084141,.15555228,.0087950351,.013396037,.071829885,.058433849,.053923286,.47895634,.22498558,.42503306
1983-10-15,1983 Q4,244720,90734,1433,3947,5380,21982,10327,16465,43677,1473,20509,6520,37157,.24226861,.22603434,.11381621,.016234268,.015793419,.059294201,.043500781,.071858399,.48137411,.18146449,.40951574
1984-1-15,1984 Q1,246424,91524,1599,3869,5468,22373,9750,16241,43405,774,21599,5364,38041,.24444954,.23599274,.10652944,.0084567983,.017470827,.059743892,.042273063,.058607578,.47424719,.17745072,.41563961
1984-4-15,1984 Q2,244265,93419,1190,4671,5861,22751,11590,16907,43047,-725,23476,2654,40393,.24353719,.25129792,.1240647,-.0077607338,.012738308,.062738843,.050000533,.028409638,.46079493,.18098031,.43238527
1984-7-15,1984 Q3,245827,94742,1382,5674,7056,23821,13829,20052,44453,-432,24253,3866,40587,.25143021,.25598994,.14596483,-.0045597516,.014586983,.074475944,.059888963,.040805556,.46920055,.21164848,.428395
1984-10-15,1984 Q4,250650,97959,1679,4565,6244,26249,10363,17357,47595,497,25752,6018,41577,.26795906,.26288548,.10578915,.0050735511,.017139824,.063740954,.046601128,.061433867,.48586655,.17718637,.42443267
1985-1-15,1985 Q1,252649,98784,1889,4417,6306,26332,9501,16753,45521,-299,26631,4487,41034,.26656139,.2695882,.096179545,-.0030268061,.01912253,.063836247,.044713721,.045422334,.46081349,.16959225,.41539115
1985-4-15,1985 Q2,258038,103424,1983,4786,6769,27041,11098,18166,47338,1146,25895,6081,41257,.26145768,.25037709,.10730585,.0110806,.019173499,.065449022,.046275526,.058796797,.45770806,.17564589,.39891127
1985-7-15,1985 Q3,258279,105007,2215,5661,7876,25849,13644,21535,46839,1330,24519,5992,40847,.24616455,.23349872,.12993419,.012665822,.021093832,.075004525,.053910691,.057062864,.44605598,.20508157,.38899311
1985-10-15,1985 Q4,258907,107213,2134,4509,6643,26663,10862,18222,48779,2282,24381,7580,41199,.24869186,.22740713,.10131234,.021284733,.019904302,.061960768,.042056467,.070700385,.4549728,.16996074,.38427243
1986-1-15,1986 Q1,261820,108513,2178,4338,6516,24128,9645,17418,45357,40,24088,4957,40400,.22235124,.22198261,.088883363,.00036861942,.020071328,.060048103,.039976776,.045681164,.41798678,.16051532,.37230563
1986-4-15,1986 Q2,263767,110330,1723,5124,6847,25243,11846,18624,49465,-703,25946,4684,44781,.22879544,.23516722,.1073688,-.0063717938,.015616786,.062059276,.04644249,.042454455,.44833681,.16880268,.40588236
1986-7-15,1986 Q3,264966,112166,1720,6479,8199,24950,14909,22189,49034,-1571,26521,3414,45620,.22243817,.23644421,.13291907,-.014006027,.015334415,.07309702,.0577626,.03043703,.43715563,.19782287,.40671861
1986-10-15,1986 Q4,269702,115626,2233,4887,7120,27358,10231,18523,52064,115,27243,7594,44470,.23660769,.23561309,.088483557,.00099458604,.019312266,.061577845,.042265579,.06567727,.45027936,.16019753,.38460207
1987-1-15,1987 Q1,272205,117982,2399,4722,7121,26554,9747,18303,49699,133,26421,7093,42606,.22506823,.22394094,.082614295,.0011272907,.02033361,.060356665,.040023055,.060119342,.42124224,.15513383,.36112288
1987-4-15,1987 Q2,276199,121829,2064,5732,7796,27162,12206,20136,50686,-1175,28337,3961,46725,.22295184,.2325965,.10018961,-.0096446658,.016941778,.063991331,.047049552,.032512784,.41604215,.16528085,.38352937
1987-7-15,1987 Q3,282910,126800,2070,7466,9536,28876,16433,24364,53369,-1582,30458,2977,50392,.22772871,.24020505,.1295978,-.012476341,.016324921,.07520505,.058880128,.023477918,.42089117,.19214511,.39741325
1987-10-15,1987 Q4,286114,129529,2086,5475,7561,28953,11797,19355,54367,-870,29823,5265,49102,.22352524,.23024188,.091076128,-.0067166425,.016104503,.05837303,.042268526,.040647268,.4197284,.149426,.37908113
1988-1-15,1988 Q1,291209,133105,1986,5441,7427,26643,11353,18676,50261,-2769,29412,1902,48359,.20016529,.22096841,.085293569,-.020803126,.014920551,.055798054,.040877502,.01428947,.37760416,.14031029,.36331469
1988-4-15,1988 Q2,292929,136147,1621,6309,7930,28107,13539,19760,52799,-3628,31735,-200,52999,.20644598,.23309363,.099443987,-.026647668,.011906249,.058245867,.04633962,-.0014690005,.38780877,.14513724,.38927776
1988-7-15,1988 Q3,297391,140831,1564,7920,9484,29333,16858,22974,53269,-4633,33966,-2433,55702,.20828511,.2411827,.11970375,-.032897588,.011105509,.067343131,.056237619,-.017276026,.37824768,.1631317,.39552373
1988-10-15,1988 Q4,299952,145524,1805,6121,7926,29395,12705,18910,53586,-4060,33455,-1510,55096,.20199417,.22989336,.087305188,-.027899178,.012403453,.054465242,.042061791,-.010376295,.36822793,.12994421,.3786042
1989-1-15,1989 Q1,301273,148564,1765,6168,7933,29288,12387,18656,52066,-4827,34115,-2695,54761,.19714062,.22963168,.083378211,-.032491047,.011880402,.05339786,.041517459,-.018140331,.35046175,.12557551,.3686021
1989-4-15,1989 Q2,303257,151393,1767,7075,8842,31661,13801,20042,54189,-5626,37287,-3796,57985,.2091312,.24629276,.091160096,-.037161559,.011671609,.058404285,.046732675,-.025073815,.35793597,.13238393,.38300979
1989-7-15,1989 Q3,303558,155573,1508,9131,10639,32703,17523,23760,55116,-5971,38674,-4025,59141,.21021,.24859069,.11263523,-.038380697,.0096931988,.068385899,.058692705,-.025872098,.3542774,.15272573,.38014951
1989-10-15,1989 Q4,303849,158994,1909,6799,8708,35081,12306,19063,58217,-1889,36970,2862,55355,.22064355,.2325245,.07739915,-.011880952,.012006742,.054769363,.042762619,.018000679,.36615849,.1198976,.34815779
1990-1-15,1990 Q1,305893,162181,2516,6719,9235,34095,12081,19347,55655,-4037,38132,-661,56316,.21022809,.23512001,.074490845,-.024891941,.015513531,.056942552,.04142902,-.0040756934,.34316596,.11929264,.34724167
1990-4-15,1990 Q2,307471,166693,1790,7942,9732,35591,14280,20122,57569,-4136,39727,-1202,58771,.21351227,.23832434,.085666463,-.02481208,.010738303,.058382776,.047644474,-.0072108605,.34535944,.12071293,.3525703
1990-7-15,1990 Q3,304257,169806,1790,9565,11355,35171,17621,24133,57243,-3369,38540,-1142,58385,.20712461,.22696489,.10377137,-.019840289,.010541442,.066870429,.056328986,-.006725322,.33710822,.142121,.34383357
1990-10-15,1990 Q4,303210,170251,2105,7250,9355,37133,12933,19967,60603,407,36726,5921,54682,.21810739,.21571679,.075964309,.0023905879,.012364098,.054948281,.042584185,.034778062,.35596266,.11727978,.32118461
1991-1-15,1991 Q1,302325,173302,2070,6672,8742,32666,11835,18508,53418,-1840,34506,1484,51934,.18849176,.19910906,.068291195,-.010617304,.011944467,.050443735,.038499266,.0085630864,.30823648,.10679623,.29967341
1991-4-15,1991 Q2,301943,175408,1777,8260,10037,36380,14531,19476,57719,-956,37336,2213,55506,.20740217,.21285231,.08284115,-.0054501505,.010130667,.05722088,.047090214,.0126163,.3290557,.11103256,.31643939
1991-7-15,1991 Q3,301285,177054,2211,9844,12055,37292,16755,23376,58468,-1246,38538,2333,56135,.21062501,.21766241,.094632149,-.0070374012,.012487716,.068086572,.055598855,.013176771,.33022693,.13202752,.31705016
1991-10-15,1991 Q4,301811,179700,2335,7653,9988,38423,12865,19416,61097,1434,36989,6808,54289,.21381748,.2058375,.071591541,.0079799667,.012993879,.055581525,.042587645,.037885364,.33999443,.10804675,.30210906
1992-1-15,1992 Q1,301831,181341,2817,7581,10398,36004,12955,20416,57147,-857,36861,2301,54846,.19854307,.20326898,.071439996,-.0047259033,.01553427,.057339486,.041805219,.012688802,.31513557,.11258347,.30244678
1992-4-15,1992 Q2,301474,181762,1983,9126,11109,38081,15817,21801,60043,-1663,39744,429,59614,.20951024,.21865956,.08702039,-.0091493269,.010909871,.061118387,.050208513,.0023602294,.33033857,.11994256,.32797834
1992-7-15,1992 Q3,303395,182216,1240,10583,11823,37027,17530,24335,59539,-2960,39987,-424,59963,.20320389,.21944834,.096204504,-.016244458,.0068051103,.064884536,.058079422,-.0023269088,.32674956,.13355029,.32907647
1992-10-15,1992 Q4,305506,185259,2932,8359,11291,41372,13271,21537,63946,583,40789,6229,57717,.22331978,.22017284,.071634844,.0031469457,.015826492,.060947105,.045120616,.033623196,.34517083,.11625346,.31154761
1993-1-15,1993 Q1,307712,189690,3387,8403,11790,41985,12372,21440,60739,-231,42216,3470,57269,.22133482,.22255258,.065222204,-.0012177763,.017855449,.06215404,.044298593,.018293004,.32020137,.11302651,.30190837
1993-4-15,1993 Q2,309236,190122,1883,10209,12092,42069,15341,21775,60821,-2373,44442,788,60033,.22127371,.23375517,.080690295,-.012481459,.0099041667,.063601263,.053697098,.0041447072,.3199051,.11453172,.3157604
1993-7-15,1993 Q3,311683,193481,2682,12259,14941,44246,18282,26755,63596,-1406,45652,1643,61953,.22868395,.23595081,.094489895,-.0072668632,.013861827,.077222049,.063360229,.0084917899,.32869378,.13828231,.32020199
1993-10-15,1993 Q4,313765,195866,3324,9564,12888,45640,13944,22865,65772,1307,44333,5756,60016,.23301645,.22634353,.071191527,.0066729295,.016970785,.065800086,.048829302,.029387439,.33580101,.11673798,.30641356
1994-1-15,1994 Q1,317468,198814,3733,9700,13433,45458,14240,23009,65237,379,45079,4844,60393,.22864588,.22673957,.071624734,.0019063044,.018776344,.067565665,.048789322,.024364481,.32813081,.11573128,.30376634
1994-4-15,1994 Q2,321166,200550,1760,11393,13153,46521,16647,23228,66385,-1997,48518,2116,64269,.23196709,.2419247,.083006732,-.0099576162,.0087758666,.065584645,.056808777,.010550985,.33101472,.11582149,.32046372
1994-7-15,1994 Q3,324811,202863,2900,13482,16382,49299,19566,28684,69757,-60,49359,5661,64096,.24301623,.24331199,.09644933,-.00029576611,.014295362,.080754004,.066458642,.027905533,.34386259,.14139591,.31595707
1994-10-15,1994 Q4,326734,207259,3461,10791,14252,51085,15533,23899,71864,1438,49647,7661,64203,.24647905,.23954086,.074944876,.006938179,.016698914,.068764202,.052065291,.036963414,.34673524,.11530983,.30977184
1995-1-15,1995 Q1,328056,208283,5405,10107,15512,53361,14401,25082,72803,4144,49217,10821,61982,.25619471,.2362987,.069141507,.019896006,.02595027,.074475594,.048525322,.051953353,.34953886,.12042269,.29758549
1995-4-15,1995 Q2,329292,210739,2610,12265,14875,52396,17241,25278,72297,-2145,54541,4543,67754,.24862982,.25880828,.081812099,-.010178467,.012384988,.070584938,.058199953,.021557471,.34306416,.11994932,.32150671
1995-7-15,1995 Q3,332436,214461,3183,14423,17606,54676,20085,30043,75684,-1664,56340,6669,69015,.25494611,.26270512,.093653388,-.0077589867,.014841859,.082094178,.067252323,.031096563,.35290334,.14008607,.32180676
1995-10-15,1995 Q4,333055,216698,4238,11452,15690,56827,15810,25610,77294,1982,54845,9739,67555,.26224053,.25309417,.072958678,.00914637,.019557172,.072404914,.052847743,.044942733,.35668996,.11818291,.31174722
1996-1-15,1996 Q1,334982,220219,3670,11747,15417,56954,15758,25396,76576,155,56799,7515,69061,.25862437,.25792053,.071556039,.00070384482,.01666523,.070007585,.053342354,.034125119,.34772658,.11532157,.31360146
1996-4-15,1996 Q2,336145,224881,3760,13469,17229,58658,18090,27299,78318,-1591,60249,5402,72916,.26084018,.26791504,.080442548,-.0070748529,.016719954,.076613851,.059893899,.024021594,.34826419,.12139309,.32424259
1996-7-15,1996 Q3,340034,229294,4152,15320,19472,59868,20819,30925,80270,-1,59869,6095,74175,.2610971,.26110145,.090796098,-4.3612131e-06,.018107757,.084921539,.066813782,.026581595,.35007459,.13487051,.32349297
1996-10-15,1996 Q4,344637,232871,4838,13099,17937,61771,18425,28526,84071,2962,58809,9442,74629,.26525846,.25253895,.079121061,.012719489,.02077545,.077025481,.056250028,.040546052,.36101961,.12249701,.32047358
1997-1-15,1997 Q1,351195,233985,5090,11906,16996,58902,17205,28110,85360,2463,56439,11373,73987,.25173408,.24120776,.073530354,.010526316,.021753531,.072637133,.050883602,.04860568,.36480972,.1201359,.31620404
1997-4-15,1997 Q2,354286,235563,4096,13633,17729,60421,20073,29626,89123,-392,60813,7955,81168,.25649613,.25816023,.085212871,-.0016640984,.01738813,.075262241,.057874113,.033770159,.37834039,.12576678,.34457025
1997-7-15,1997 Q3,356780,242589,4734,16145,20879,62250,23781,33912,91185,1071,61179,9465,81720,.25660685,.25219199,.098030001,.0044148746,.019514488,.086067379,.066552892,.039016608,.37588266,.139792,.33686605
1997-10-15,1997 Q4,360993,239613,4097,13352,17449,61733,20324,29895,92817,1115,60618,10630,82187,.25763628,.25298294,.084820107,.0046533369,.017098404,.072821595,.055723187,.044363201,.38736212,.12476368,.34299892
1998-1-15,1998 Q1,364276,243273,4936,12861,17797,59406,19504,30678,90415,-76,59482,8620,81795,.24419479,.24450719,.080173306,-.00031240622,.020289963,.073156498,.052866533,.035433441,.37166065,.12610523,.33622721
1998-4-15,1998 Q2,367660,246876,4111,14695,18806,60139,21944,32341,91921,-2148,62287,5852,86069,.24360003,.25230074,.08888673,-.0087007247,.016652085,.076175891,.05952381,.023704208,.37233672,.131001,.34863251
1998-7-15,1998 Q3,370263,250242,3938,16882,20820,60539,25125,35532,92884,-2932,63471,4556,88328,.24192181,.25363848,.10040281,-.011716658,.015736766,.083199464,.067462698,.018206377,.37117669,.14199056,.35297033
1998-10-15,1998 Q4,373826,256856,4363,14824,19187,60750,21627,31622,92773,-1590,62340,5958,86815,.23651384,.24270408,.084198929,-.006190239,.016986171,.074699439,.05771327,.023195876,.3611868,.12311178,.33799094
1999-1-15,1999 Q1,376026,257971,4213,14524,18737,57811,21447,31419,89117,-4138,61949,2642,86475,.22409883,.24013939,.083137251,-.016040564,.016331293,.072632194,.056300901,.010241461,.34545356,.12179276,.33521211
1999-4-15,1999 Q2,376682,256599,3888,16682,20570,60947,24782,33871,92755,-3783,64730,2447,90308,.23751846,.25226131,.09657871,-.014742848,.015152046,.080163993,.065011948,.0095362803,.36147842,.13199973,.35194212
1999-7-15,1999 Q3,383148,260238,3161,18550,21711,64045,27892,35611,96790,-4698,68743,1162,95628,.24610165,.26415434,.10717881,-.018052706,.012146574,.083427481,.071280904,.0044651437,.37192878,.13684012,.36746362
1999-10-15,1999 Q4,388806,264944,5025,16086,21111,66063,24317,34048,99633,-2288,68351,4383,95250,.24934703,.25798282,.091781661,-.0086357873,.018966272,.079680987,.060714718,.016543118,.37605307,.12851018,.35950994
2000-1-15,2000 Q1,391937,270734,4935,14996,19931,64878,22722,33266,98365,-3472,68350,3598,94767,.23963743,.25246182,.0839274,-.012824396,.018228224,.073618382,.055390161,.013289797,.36332712,.12287337,.35003731
2000-4-15,2000 Q2,394312,273515,4440,17456,21896,68189,25804,35696,101821,-4514,72703,2568,99253,.24930625,.26580992,.094342172,-.016503666,.016233113,.080054112,.063820995,.0093888817,.37226844,.13050838,.36287954
2000-7-15,2000 Q3,395469,275409,3705,20445,24150,70003,29672,39412,103794,-7111,77114,170,103624,.25417835,.27999812,.10773794,-.02581978,.013452719,.087687768,.074235044,.00061726378,.37687221,.14310353,.37625495
2000-10-15,2000 Q4,396403,276242,5299,17377,22676,73064,25604,36490,108106,-4457,77521,3484,104622,.26449272,.28062713,.092686847,-.016134404,.019182457,.082087442,.062904991,.01261213,.39134526,.13209432,.37873313
2001-1-15,2001 Q1,401021,278908,6428,16868,23296,73442,24498,36454,107833,-4695,78137,2186,105647,.26331979,.2801533,.087835416,-.016833508,.023047026,.083525747,.060478725,.00783771,.38662571,.1307026,.37878799
2001-4-15,2001 Q2,404118,285103,5340,18997,24337,72539,26869,37653,105542,-7430,79969,-1916,107458,.25443086,.28049162,.094243132,-.026060756,.018730072,.085362129,.066632062,-.0067203781,.37018901,.13206805,.3769094
2001-7-15,2001 Q3,407236,285857,3401,21706,25107,70462,30979,38901,103189,-8557,79019,-4746,107935,.24649388,.27642843,.10837237,-.029934548,.011897557,.087830625,.075933069,-.016602706,.3609812,.13608553,.37758389
2001-10-15,2001 Q4,408833,288507,5434,17562,22996,70358,25228,35363,104539,-5232,75590,-1451,105990,.2438693,.26200405,.087443285,-.018134741,.018834898,.079706907,.060872007,-.0050293407,.36234477,.12257241,.36737409
2002-1-15,2002 Q1,410434,291400,5161,17530,22691,68778,25520,35685,102783,-6766,75544,-3669,106452,.23602608,.25924504,.087577216,-.023218943,.017711051,.077868909,.060157858,-.01259094,.35272133,.12246054,.36531228
2002-4-15,2002 Q2,412445,294478,3912,19940,23852,73651,28139,36013,108102,-8651,82302,-6761,114863,.25010696,.27948436,.095555529,-.029377406,.013284524,.080997564,.067713037,-.02295927,.36709702,.12229437,.39005631
2002-7-15,2002 Q3,415187,298755,4789,23202,27991,74202,33117,42511,109299,-8281,82483,-6582,115881,.24837074,.2760891,.11085003,-.027718365,.016029857,.093692154,.077662297,-.02203143,.36584827,.14229386,.3878797
2002-10-15,2002 Q4,418465,303038,6038,19320,25358,71089,27612,37799,105472,-8223,79312,-6867,112339,.23458774,.26172295,.091117285,-.02713521,.019924894,.083679274,.06375438,-.022660524,.34804875,.12473353,.37070927
2003-1-15,2003 Q1,421580,307070,7961,19353,27314,74942,27588,41176,108863,-4397,79339,-2381,111244,.24405511,.2583743,.089842707,-.01431921,.025925685,.088950403,.063024715,-.0077539324,.35452178,.13409321,.36227569
2003-4-15,2003 Q2,425428,310584,5827,21516,27343,74170,29473,40109,106879,-7218,81388,-6526,113405,.23880818,.26204827,.094895422,-.023240089,.01876143,.088037372,.069275945,-.021012029,.34412268,.12914059,.36513472
2003-7-15,2003 Q3,430274,316568,5242,25182,30424,76004,34350,44168,109182,-8925,84929,-8005,117187,.24008743,.26828045,.10850749,-.028192995,.016558843,.096105732,.079546891,-.025286825,.34489271,.13952136,.37017956
2003-10-15,2003 Q4,434277,321966,6594,20304,26898,75429,28495,40379,110644,-7572,83001,-5444,116088,.23427629,.25779429,.088503137,-.023518011,.020480424,.08354298,.063062556,-.016908618,.34365121,.12541386,.36055982
2004-1-15,2004 Q1,435802,322897,8033,20313,28346,73797,29342,43245,109606,-7421,81218,-6310,115916,.22854656,.25152913,.090871081,-.02298256,.024877902,.087786511,.062908605,-.019541835,.33944571,.13392815,.35898754
2004-4-15,2004 Q2,437406,329033,6598,22894,29492,76620,32103,44292,111763,-9366,85986,-8716,120479,.23286419,.26132941,.097567722,-.02846523,.020052699,.089632347,.069579646,-.026489744,.33967111,.13461263,.36616084
2004-7-15,2004 Q3,438191,330791,5683,26213,31896,79401,36662,48256,115232,-10854,90255,-10615,125847,.24003373,.27284598,.11083131,-.03281226,.017180033,.096423425,.079243392,-.032089747,.34835288,.14588062,.38044265
2004-10-15,2004 Q4,439291,334738,9423,22644,32067,83663,31031,47316,119252,-6153,89816,-4912,124164,.24993578,.26831731,.092702352,-.01838154,.028150374,.095797308,.067646936,-.014674163,.35625476,.14135234,.37092891
2005-1-15,2005 Q1,442793,337926,8834,22208,31042,78667,31211,47755,113581,-8393,87060,-7135,120716,.23279357,.25763038,.092360459,-.024836799,.026141819,.091860346,.065718532,-.02111409,.33611205,.14131792,.35722613
2005-4-15,2005 Q2,447996,346983,9033,24639,33672,86902,33571,46769,120715,-7737,94639,-8779,129494,.25045031,.27274823,.096751139,-.022297923,.026032975,.097042218,.071009241,-.025300952,.3478989,.13478759,.37319985
2005-7-15,2005 Q3,452721,349720,7907,28502,36409,90267,38356,53647,127795,-10624,100891,-7362,135157,.25811219,.2884908,.10967631,-.030378589,.022609517,.104109,.081499487,-.021051127,.36542091,.15339987,.38647205
2005-10-15,2005 Q4,458925,358409,10288,24452,34740,93269,32873,48560,129747,-7196,100465,-4903,134650,.26023063,.28030825,.09171924,-.020077622,.028704636,.096928373,.06822373,-.013679902,.36200821,.13548768,.37568811
2006-1-15,2006 Q1,461059,361619,11778,24779,36557,101957,33626,52904,142923,-8690,110647,-4684,147607,.28194591,.30597672,.092987373,-.024030818,.032570191,.10109258,.068522394,-.01295286,.39523089,.14629762,.40818375
2006-4-15,2006 Q2,462305,366410,9789,26753,36542,107488,35092,50599,147532,-8224,115712,-5374,152906,.29335445,.31579924,.095772497,-.022444801,.026715973,.099729814,.073013835,-.01466663,.40264186,.13809393,.41730848
2006-7-15,2006 Q3,462734,369568,11970,30256,42226,96759,40247,59065,132882,-8952,105711,-6771,139653,.2618165,.28603938,.10890283,-.024222877,.032389168,.11425773,.081868559,-.018321391,.35956034,.15982173,.37788174
2006-10-15,2006 Q4,464891,373122,13986,25386,39372,94958,33328,53798,131072,-5376,100334,-2476,133548,.25449586,.268904,.089321993,-.014408156,.037483718,.10552045,.068036728,-.0066358992,.35128456,.1441834,.35792047
2007-1-15,2007 Q1,469274,378624,15100,25005,40105,93486,33546,57909,132452,-7384,100870,-3214,135666,.24690986,.26641205,.088599771,-.019502198,.039881255,.10592303,.066041775,-.0084886327,.34982464,.15294594,.35831326
2007-4-15,2007 Q2,471920,383376,13086,27700,40786,97301,35805,57318,134805,-6861,104162,-2003,136808,.25380045,.27169672,.093393952,-.017896269,.034133591,.10638642,.072252825,-.0052246358,.35162607,.14950858,.35685071
2007-7-15,2007 Q3,475530,389461,13031,31330,44361,98653,40569,61469,135869,-11492,110145,-8515,144384,.25330648,.28281394,.10416704,-.029507447,.033459064,.11390357,.080444515,-.02186355,.3488642,.15783095,.37072775
2007-10-15,2007 Q4,477958,394624,16313,26856,43169,102669,34467,61017,140125,-5860,108529,1192,138933,.26016918,.27501875,.087341368,-.014849578,.041338082,.10939274,.068054654,.0030205969,.35508484,.1546206,.35206425
2008-1-15,2008 Q1,480523,400688,13103,27838,40941,100578,35061,59385,134852,-10352,110930,-1345,136197,.25101325,.27684882,.087501995,-.025835562,.032701254,.10217676,.069475502,-.0033567264,.33655113,.14820759,.33990785
2008-4-15,2008 Q2,477834,398915,13639,29649,43288,109583,35269,59721,138504,-9281,118864,439,138065,.27470264,.29796824,.088412322,-.023265608,.034190241,.10851435,.074324101,.0011004851,.34720179,.14970858,.34610131
2008-7-15,2008 Q3,470368,397188,11948,33989,45937,111424,39371,62003,138909,-10614,122038,-49,138958,.28053215,.307255,.099124342,-.026722861,.030081473,.11565556,.085574083,-.00012336727,.34973112,.15610492,.34985447
2008-10-15,2008 Q4,460676,392468,17332,29434,46766,108254,33890,58104,133115,-4441,112695,3635,129480,.27582887,.28714442,.086350992,-.011315572,.044161562,.11915876,.074997194,.0092619015,.33917415,.14804775,.32991225
2009-1-15,2009 Q1,452896,384441,16355,28495,44850,99486,32197,55666,121853,-6039,105525,1459,120394,.25878093,.27448946,.083750173,-.015708523,.04254229,.1166629,.074120604,.0037951206,.3169615,.14479725,.31316638
2009-4-15,2009 Q2,452036,385619,15143,30415,45558,100294,34137,57272,123126,-5480,105774,967,122159,.26008573,.27429664,.088525206,-.014210918,.039269332,.11814252,.078873187,.0025076566,.31929442,.14851965,.31678677
2009-7-15,2009 Q3,452595,389776,13058,33573,46631,102636,37408,59034,126082,-8382,111018,-2829,128911,.26332048,.28482512,.095973074,-.021504659,.033501294,.11963538,.086134084,-.0072580148,.32347298,.15145622,.33073097
2009-10-15,2009 Q4,454145,388677,15633,28406,44039,106335,32235,55497,128574,-4970,111305,805,127769,.27358192,.28636888,.082935184,-.012786967,.040221058,.11330488,.073083818,.0020711285,.3307991,.14278437,.32872796
2010-1-15,2010 Q1,457058,394878,14980,28097,43077,105091,31743,53941,124345,-6542,111633,-2005,126350,.26613536,.28270251,.080386855,-.016567143,.037935767,.10908939,.071153626,-.0050775176,.31489474,.13660169,.31997225
2010-4-15,2010 Q2,461765,401588,16903,30844,47747,114748,33712,57488,132461,-5383,120131,-570,133031,.28573564,.29913992,.083946735,-.013404285,.042090401,.11889549,.076805085,-.0014193652,.32984301,.14315169,.33126238
2010-7-15,2010 Q3,465134,403451,13177,34574,47751,113510,37930,57303,132646,-12388,125898,-7552,140198,.28134766,.31205276,.094013892,-.030705092,.032660719,.11835638,.085695662,-.018718505,.32877848,.14203212,.34749696
2010-10-15,2010 Q4,465290,406110,19196,29664,48860,120354,32882,58902,139278,-6810,127164,78,139200,.29635814,.31312698,.080968209,-.016768856,.047267981,.12031223,.073044248,.00019206619,.34295633,.14503953,.34276429
2011-1-15,2011 Q1,466970,414242,18016,28559,46575,122321,31923,55758,138149,-2981,125302,4115,134034,.29528874,.30248502,.07706365,-.0071962764,.043491486,.11243428,.068942793,.009933807,.3334983,.13460247,.3235645
2011-4-15,2011 Q2,467370,411759,21563,31978,53541,128398,34306,62896,141289,-976,129374,7344,133945,.31182805,.31419834,.083315723,-.0023703186,.052368011,.13002995,.077661932,.017835675,.34313518,.15274954,.3252995
2011-7-15,2011 Q3,468942,414864,19944,35410,55354,128678,37790,66064,143139,-8792,137470,1885,141254,.3101691,.33136159,.091090091,-.021192487,.048073586,.13342686,.08535327,.0045436579,.34502631,.15924254,.34048265
2011-10-15,2011 Q4,469556,419276,21900,30723,52623,130493,33651,61508,144350,-3088,133581,6011,138339,.31123412,.31859919,.080259778,-.0073650768,.052232895,.12550922,.073276311,.014336619,.34428397,.1467005,.32994735
2012-1-15,2012 Q1,472809,421447,21019,29895,50914,129054,33345,60479,142983,-3548,132602,5566,137417,.30621645,.31463507,.079120271,-.008418615,.049873412,.1208076,.070934184,.013206881,.33926687,.14350322,.32605997
2012-4-15,2012 Q2,472114,423697,20866,33231,54097,127157,36085,62716,140377,-6160,133317,1165,139212,.30011305,.31465176,.085166991,-.014538691,.049247459,.12767851,.078431047,.0027496065,.33131459,.14802088,.328565
2012-7-15,2012 Q3,477869,432624,18967,36250,55217,128192,39333,65166,143499,-8211,136403,538,142961,.29631272,.31529227,.090917289,-.018979529,.043841764,.12763277,.083791003,.0012435741,.33169448,.15062964,.33045092
2012-10-15,2012 Q4,476834,434002,24383,30304,54687,128914,33305,64088,143704,-3271,132185,5028,138676,.29703549,.30457234,.076739281,-.0075368318,.05618177,.12600634,.069824561,.0115852,.3311137,.14766753,.31952849
2013-1-15,2013 Q1,479357,436035,24273,30906,55179,128775,33507,62414,139018,-3338,132113,3665,135353,.29533181,.30298716,.076844752,-.0076553486,.055667549,.12654719,.070879631,.0084052887,.31882304,.14313988,.31041774
2013-4-15,2013 Q2,483211,440203,25329,35113,60442,137178,36678,67675,148219,-1323,138501,5833,142386,.31162441,.31462985,.083320647,-.0030054315,.057539362,.13730483,.079765469,.013250705,.33670601,.15373589,.3234553
2013-7-15,2013 Q3,487728,449241,20384,38907,59291,133999,40527,66227,144491,-9830,143829,-3292,147783,.29827866,.32016,.090212159,-.021881351,.045374308,.13198039,.086606078,-.0073279152,.32163361,.14741977,.32896152
2013-10-15,2013 Q4,490859,454857,24004,32964,56968,131838,35569,63418,143715,-10515,142353,-6207,149922,.28984493,.31296209,.078198202,-.023117155,.05277263,.12524375,.072471127,-.013646047,.31595644,.13942404,.32960248
2014-1-15,2014 Q1,494629,459591,21756,32260,54016,126217,35347,60073,138364,-6871,133088,-3472,141836,.27462897,.28957921,.076909684,-.014950249,.047337741,.11753058,.070192844,-.0075545432,.30105898,.13070969,.30861354
2014-4-15,2014 Q2,497849,463641,23798,35580,59378,132161,37897,64967,143994,-3751,135912,-500,144494,.28505027,.29314059,.081737809,-.0080903117,.051328506,.12806891,.076740406,-.0010784206,.31057218,.1401235,.3116506
2014-7-15,2014 Q3,500658,468959,20127,40482,60609,130489,43380,67332,143961,-11548,142037,-8170,152131,.27825248,.30287722,.092502758,-.024624754,.042918462,.12924157,.086323112,-.017421566,.30697992,.14357759,.3244015
2014-10-15,2014 Q4,503589,470817,26338,35930,62268,136457,39306,67402,150480,-6763,143220,-5776,156256,.28983024,.30419463,.083484665,-.014364392,.055941056,.13225521,.076314151,-.012268037,.31961462,.14315966,.33188266
2015-1-15,2015 Q1,506314,473838,21795,34977,56772,125810,38934,61911,141038,-11748,137558,-13204,154242,.26551268,.29030597,.08216732,-.024793284,.045996733,.1198131,.073816366,-.027866064,.29765025,.13065858,.32551631
2015-4-15,2015 Q2,510095,480944,22823,38812,61635,135340,43078,67879,152543,-1389,136729,-1359,153902,.28140491,.28429297,.08956968,-.0028880702,.047454588,.12815422,.080699623,-.0028256928,.31717414,.14113702,.31999984
2015-7-15,2015 Q3,512070,481713,16585,42721,59306,127123,47117,66522,146842,-12392,139515,-12224,159066,.26389781,.28962266,.097811349,-.025724862,.034429215,.1231148,.088685587,-.025376106,.30483297,.13809468,.33020908
2015-10-15,2015 Q4,515430,483146,26647,37317,63964,135093,41707,68236,152523,-2743,137836,-7168,159691,.27961114,.28528851,.086323805,-.0056773727,.055153102,.13239062,.077237524,-.014836095,.31568718,.14123267,.33052328
2016-1-15,2016 Q1,516456,489770,22492,36641,59133,128139,40465,63893,144466,-8960,137099,-12650,157116,.26163098,.27992526,.082620412,-.018294301,.045923598,.12073626,.074812666,-.025828451,.29496703,.13045511,.32079548
2016-4-15,2016 Q2,518794,497175,25896,40151,66047,140888,42737,71595,156464,-2674,143562,-3240,159704,.28337708,.28875548,.085959673,-.0053783879,.052086286,.13284457,.080758281,-.0065168198,.31470609,.14400361,.3212229
2016-7-15,2016 Q3,520379,500613,18434,49451,67885,139622,49295,70653,148256,-21884,161506,-22371,170627,.27890205,.32261646,.09846928,-.043714408,.036822855,.13560376,.098780893,-.044687215,.29614893,.14113297,.34083614
2016-10-15,2016 Q4,523484,507154,29897,42731,72628,154599,43645,74382,160012,-2595,157194,-4184,164196,.30483639,.30995318,.086058669,-.0051167891,.058950536,.143207,.084256455,-.0082499599,.31550968,.14666551,.32375965
2017-1-15,2017 Q1,526081,512085,25370,41047,66417,149406,42211,68067,154108,-8810,158216,-9718,163826,.29176015,.30896434,.082429677,-.017204175,.049542557,.12969917,.080156617,-.018977318,.30094221,.13292129,.31991956
2017-4-15,2017 Q2,527622,513953,27030,45374,72404,156408,45805,73733,161746,-4330,160738,-3992,165738,.30432355,.31274843,.089122936,-.0084248949,.052592359,.1408767,.088284336,-.007767247,.31470972,.14346254,.32247695
2017-7-15,2017 Q3,529856,517482,23067,51515,74582,156496,50714,76518,161904,-12958,169454,-10337,172241,.30241826,.32745874,.09800148,-.025040485,.044575464,.14412482,.099549353,-.019975575,.31286886,.14786601,.33284444
2017-10-15,2017 Q4,531737,525237,30029,43228,73257,160558,43733,74189,164385,-3791,164349,-2707,167092,.30568677,.31290445,.083263367,-.0072176941,.057172287,.13947418,.082301892,-.0051538637,.31297299,.14124861,.31812686
2018-1-15,2018 Q1,532104,527869,27532,44394,71926,156714,44976,73185,160977,-6058,162772,-4927,165904,.29688048,.30835682,.085202955,-.011476332,.05215688,.13625729,.08410041,-.0093337549,.30495635,.13864236,.31429011
2018-4-15,2018 Q2,534140,532966,28688,48772,77460,164975,49076,77108,165149,-1936,166911,-3020,168169,.30954131,.31317383,.092080921,-.0036325019,.053827073,.1453376,.091510527,-.0056664026,.3098678,.14467715,.3155342
2018-7-15,2018 Q3,537326,539287,23477,55359,78836,166527,54299,79059,164735,-10878,177405,-9893,174628,.30879104,.32896212,.10068665,-.020171078,.043533407,.14618561,.10265221,-.018344592,.30546814,.14659911,.32381272
2018-10-15,2018 Q4,538222,541670,31659,50588,82247,173385,50762,81117,170740,-6615,180000,-7647,178387,.32009342,.33230564,.093713887,-.012212233,.058447026,.15183969,.093392655,-.014117451,.31521037,.14975354,.32932782
2019-1-15,2019 Q1,541195,548802,24062,46693,70755,161313,47183,71550,162059,-25606,186919,-25497,187556,.29393661,.34059459,.085974544,-.046657994,.043844592,.12892628,.085081689,-.046459381,.29529592,.13037489,.3417553
2019-4-15,2019 Q2,541944,551964,27299,52005,79304,164104,50680,77793,160935,-6078,170182,-7120,168055,.29730925,.30832082,.09181758,-.011011587,.049457937,.14367604,.094218098,-.012899392,.29156792,.14093854,.30446732
2019-7-15,2019 Q3,544639,558286,20018,62080,82098,174748,58111,81057,170948,-12377,187125,-8280,179228,.31300804,.33517766,.10408822,-.02216964,.035856172,.14705366,.11119749,-.014831108,.30620149,.14518903,.32103258
2019-10-15,2019 Q4,544733,559387,31954,52209,84163,189109,51434,81438,185244,16591,172518,14211,171033,.3380647,.30840546,.091947079,.029659253,.057123244,.15045577,.093332522,.025404595,.33115536,.14558436,.30575076
2020-1-15,2020 Q1,528287,554315,26751,46454,73205,156024,46796,70362,153359,-1975,157999,-4420,157779,.28147173,.28503469,.084421314,-.0035629561,.048259564,.1320639,.083804332,-.0079738051,.27666399,.12693505,.28463781
2020-4-15,2020 Q2,429219,476341,31161,37830,68991,140540,36411,64312,140359,20204,120336,19149,121210,.29504073,.25262573,.076438941,.042414993,.065417424,.14483532,.079417899,.040200192,.29466075,.13501252,.25446057
2020-7-15,2020 Q3,497909,540164,30223,36425,66648,140128,34255,64822,138995,-2540,142668,-1307,140302,.2594175,.26411977,.063415922,-.0047022756,.055951525,.12338475,.067433223,-.0024196354,.25731999,.1200043,.25973964
