Date,date,ABMI,YBHA,KTMS,KTMR,KTMQ,KTMW,KTMU,KTMT,KTMZ,KTMY,KTMX,KTNC,KTNB,KTMW_gdp,KTMX_gdp,KTMY_gdp,KTMS_gdp,KTMQ_gdp,KTMR_gdp,frequency
1948,1948,365418,11425,-64,641,577,2240,18816,25555,43345,-216,2456,806,42539,.19606127,.21496718,-.018905908,-.0056017507,.050503284,.056105033,annual
1949,1949,377558,12168,-43,695,652,2543,19991,27813,47854,-181,2724,2163,45691,.2089908,.22386588,-.014875082,-.0035338593,.053583167,.05711703,annual
1950,1950,390150,12737,-4,759,755,3048,19962,31140,54384,-59,3107,8424,45960,.23930281,.24393499,-.004632174,-.0003140457,.059276126,.059590172,annual
1951,1951,404591,14298,32,901,933,3712,20961,30398,53652,-661,4373,4689,48963,.25961673,.30584696,-.046230242,.0022380752,.065253884,.063015804,annual
1952,1952,410688,15528,123,885,1008,3825,19171,29322,52366,-151,3976,7154,45212,.24632922,.25605357,-.0097243693,.0079211751,.064914994,.056993816,annual
1953,1953,433512,16675,122,902,1024,3753,20362,30195,54392,-124,3877,5780,48612,.22506747,.23250374,-.007436282,.0073163416,.061409295,.054092955,annual
1954,1954,452371,17589,114,965,1079,3908,20835,31846,57276,-99,4007,7022,50254,.22218432,.22781284,-.0056285178,.0064813234,.06134516,.054863837,annual
1955,1955,470517,19160,41,1086,1127,4254,25370,31963,61014,-277,4531,5994,55020,.22202505,.23648225,-.014457203,.0021398747,.05882046,.056680586,annual
1956,1956,478458,20832,25,1220,1245,4684,25463,31225,63538,69,4615,8530,55008,.22484639,.22153418,.0033122119,.0012000768,.059763826,.058563747,annual
1957,1957,487920,22093,120,1232,1352,4925,24503,32605,64949,81,4844,8749,56200,.22292128,.21925497,.0036663197,.0054315845,.061195854,.055764269,annual
1958,1958,494469,23210,117,1201,1318,4788,25019,33086,63801,139,4649,7149,56652,.20629039,.20030159,.0059887981,.0050409306,.056785867,.051744938,annual
1959,1959,515587,24378,116,1235,1351,4938,25456,33839,65321,-13,4951,5159,60162,.20255968,.20309295,-.00053326768,.0047583887,.055418819,.050660431,annual
1960,1960,548182,26189,36,1411,1447,5248,28280,36118,68852,-382,5630,1715,67137,.20038947,.21497576,-.014586276,.0013746229,.055252206,.053877581,annual
1961,1961,562843,27905,48,1470,1518,5485,28280,36843,70742,-112,5597,4309,66433,.19655976,.20057337,-.0040136175,.0017201218,.054398853,.05267873,annual
1962,1962,568897,29224,47,1510,1557,5622,28376,36819,71645,-75,5697,4072,67573,.19237612,.19494252,-.0025663837,.0016082672,.053278126,.051669862,annual
1963,1963,596399,31091,1,1582,1583,5978,27717,36370,74779,-141,6119,4964,69815,.19227429,.19680937,-.0045350743,.000032163647,.050915055,.050882891,annual
1964,1964,630411,34043,-37,1724,1687,6319,29417,37013,76931,-610,6929,-49,76980,.18561819,.2035367,-.017918514,-.0010868608,.049554974,.050641835,annual
1965,1965,643723,36826,-70,1826,1756,6739,29860,36750,79914,-358,7097,2490,77424,.18299571,.19271711,-.0097213928,-.0019008309,.047683701,.049584534,annual
1966,1966,653694,39394,39,1915,1954,7302,30400,39240,83720,-105,7407,4605,79115,.18535818,.18802355,-.0026653805,.00098999846,.049601462,.048611462,annual
1967,1967,671765,41684,151,2060,2211,7540,30623,40705,83904,-495,8035,-520,84424,.18088475,.19275981,-.01187506,.003622493,.053041935,.04941944,annual
1968,1968,708384,45809,333,2286,2619,9156,30533,44019,93986,-437,9593,3437,90549,.19987339,.20941299,-.0095396098,.007269314,.057172172,.049902856,annual
1969,1969,721970,49785,382,2524,2906,10279,33432,47952,102844,99,10180,9529,93315,.20646781,.20447926,.0019885509,.0076729939,.058370996,.050698001,annual
1970,1970,741420,56057,443,3039,3482,11748,33777,51285,107967,349,11399,10380,97587,.2095724,.2033466,.0062258057,.0079026707,.062115345,.054212678,annual
1971,1971,768159,62885,602,3419,4021,13211,35856,55587,115319,722,12489,12801,102518,.21008189,.19860062,.011481276,.0095730303,.063942119,.054369088,annual
1972,1972,801160,70553,703,3673,4376,13963,37366,57743,116506,-126,14089,4376,112130,.19790795,.19969384,-.0017858915,.0099641401,.062024295,.052060153,annual
1973,1973,853211,81746,883,4600,5483,17574,38201,63139,130591,-1793,19367,6483,124108,.214983,.2369168,-.021933794,.010801752,.067073621,.056271866,annual
1974,1974,831823,92612,1255,5764,7019,23565,39363,67872,140013,-4102,27667,14707,125306,.25444868,.29874098,-.044292316,.01355116,.075789317,.062238153,annual
1975,1975,819361,115027,1659,6597,8256,27707,39958,68231,135896,-1719,29426,18869,117027,.24087389,.25581819,-.014944318,.014422701,.071774453,.057351753,annual
1976,1976,844053,136901,2811,7970,10781,36185,39928,72389,147878,-1268,37453,25132,122746,.2643151,.27357724,-.0092621678,.020533087,.078750335,.058217254,annual
1977,1977,864606,159631,3632,8894,12526,44567,40139,74564,157478,1193,43374,32631,124847,.27918762,.27171415,.0074734855,.022752473,.078468464,.055715997,annual
1978,1978,900728,185960,4127,9392,13519,48850,40035,74249,159951,2417,46433,30761,129190,.2626909,.24969348,.012997419,.022192944,.072698429,.050505485,annual
1979,1979,934253,220721,4461,11216,15677,56526,43140,75231,165589,947,55579,24396,141193,.25609708,.25180659,.0042904844,.020211035,.071026318,.050815284,annual
1980,1980,915042,259663,4275,12698,16973,64466,44668,71943,164693,5398,59068,28515,136178,.24826795,.22747946,.020788483,.016463647,.065365493,.048901845,annual
1981,1981,908707,289840,4604,14043,18647,69681,45129,71965,163543,7590,62091,31280,132263,.24041195,.21422508,.026186861,.015884627,.064335495,.048450869,annual
1982,1982,926621,319212,4062,15607,19669,75326,45727,68936,164886,5676,69650,26645,138241,.23597483,.21819355,.017781286,.012725086,.06161736,.048892271,annual
1983,1983,965509,351051,5175,16780,21955,82939,44317,69248,167727,3283,79656,20989,146738,.23625912,.22690721,.0093519175,.014741448,.06254077,.047799323,annual
1984,1984,987166,377644,5850,18779,24629,95194,45532,70557,178500,114,95080,17902,160598,.25207338,.25177151,.00030187159,.01549078,.06521751,.049726728,annual
1985,1985,1027873,414428,8221,19373,27594,105885,45105,74676,188477,4459,101426,24140,164337,.25549674,.24473733,.010759409,.019836981,.066583335,.046746358,annual
1986,1986,1060255,446635,7854,20828,28682,101679,46631,76754,195920,-2119,103798,20649,175271,.22765569,.23240006,-.0047443663,.017584829,.064217985,.046633158,annual
1987,1987,1117428,496140,8619,23395,32014,111545,50183,82158,208121,-3494,115039,19296,188825,.22482565,.23186801,-.007042367,.017372113,.064526141,.047154028,annual
1988,1988,1181481,555607,6976,25791,32767,113478,54455,80320,209915,-15090,128568,-2241,212156,.20424148,.23140097,-.027159484,.012555637,.058975138,.046419501,annual
1989,1989,1211937,614524,6949,29173,36122,128733,56017,81521,219588,-18313,147046,-7654,227242,.20948409,.2392844,-.029800301,.011307939,.058780454,.047472514,annual
1990,1990,1220831,668931,8201,31476,39677,141990,56915,83569,231070,-11135,153125,2916,228154,.21226405,.22891001,-.016645962,.01225986,.059314039,.047054179,annual
1991,1991,1207364,705464,8393,32429,40822,144761,55986,80776,230702,-2608,147369,12838,217864,.2051997,.20889656,-.0036968577,.011897135,.057865463,.045968328,annual
1992,1992,1212206,730578,8972,35649,44621,152484,59573,88089,240675,-4897,157381,8535,232140,.20871693,.21541984,-.006702912,.012280688,.061076298,.048795611,annual
1993,1993,1242396,769159,11276,40435,51711,173940,59939,92835,250928,-2703,176643,11657,239271,.22614309,.22965732,-.0035142279,.014660168,.067230575,.052570406,annual
1994,1994,1290179,809486,11854,45366,57220,192363,65986,98820,273243,-240,192603,20282,252961,.23763599,.23793246,-.00029648445,.01464386,.070686832,.056042969,annual
1995,1995,1322839,850181,15436,48247,63683,217260,67537,106013,298078,2317,214943,31772,266306,.25554559,.25282028,.002725302,.018156134,.074905224,.056749091,annual
1996,1996,1355798,907265,16420,53635,70055,237251,73092,112146,319235,1525,235726,28454,290781,.26150131,.25982046,.001680876,.018098351,.07721559,.059117235,annual
1997,1997,1423254,951750,18017,55036,73053,243306,81383,121543,358485,4257,239049,39423,319062,.25564066,.25116783,.0044728131,.01893039,.0767565,.057826109,annual
1998,1998,1476025,997247,17348,59262,76610,240834,88200,130173,367993,-6746,247580,24986,343007,.24149884,.24826346,-.0067646229,.017395891,.076821491,.0594256,annual
1999,1999,1524662,1039752,16287,65842,82129,248866,98438,134949,378295,-14907,263773,10634,367661,.2393513,.25368837,-.014337073,.015664313,.078989029,.063324712,annual
2000,2000,1578121,1095900,18379,70274,88653,276134,103802,144864,412086,-19554,295688,9820,402266,.25197008,.26981294,-.017842868,.016770691,.080895156,.064124465,annual
2001,2001,1621208,1138375,20603,75133,95736,286801,107574,148371,421103,-25914,312715,-5927,427030,.25193894,.27470297,-.022764027,.018098606,.084098823,.066000223,annual
2002,2002,1656531,1187671,19900,79992,99892,287720,114388,152008,425656,-31921,319641,-23879,449535,.24225564,.26913261,-.026876971,.016755482,.084107466,.067351982,annual
2003,2003,1711559,1256188,25624,86355,111979,300545,119906,165832,435568,-28112,328657,-22356,457924,.23925161,.26163042,-.022378815,.02039822,.089141913,.068743691,annual
2004,2004,1750690,1317459,29737,92064,121801,313481,129138,183109,455853,-33794,347275,-30553,486406,.23794365,.26359454,-.025650892,.02257148,.092451453,.069879971,annual
2005,2005,1802435,1393038,36062,99801,135863,349105,136011,196731,491838,-33950,383055,-28179,520017,.25060695,.27497813,-.024371194,.025887305,.09753,.071642697,annual
2006,2006,1850989,1470719,47523,107174,154697,401162,142293,216366,554409,-31242,432404,-19305,573714,.2727659,.29400858,-.021242671,.032312766,.10518461,.072871841,annual
2007,2007,1894682,1546085,57530,110891,168421,392109,144387,237713,543251,-31597,423706,-12540,555791,.25361413,.27405092,-.020436781,.037210114,.10893386,.071723744,annual
2008,2008,1889401,1589259,56022,120910,176932,429839,143591,239213,545380,-34688,464527,2680,542700,.27046505,.29229155,-.021826524,.035250392,.11132987,.07607948,annual
2009,2009,1811672,1548513,60189,120889,181078,408751,135977,227469,499635,-24871,433622,402,499233,.26396355,.28002477,-.016061215,.0388689,.1169367,.078067794,annual
2010,2010,1849247,1606027,64256,123179,187435,453703,136267,227634,528730,-31123,484826,-10049,538779,.28250024,.30187911,-.019378876,.04000929,.11670725,.07669796,annual
2011,2011,1872838,1660141,81423,126670,208093,509890,137670,246226,566927,-15837,525727,19355,547572,.30713657,.31667611,-.0095395511,.049045835,.12534659,.076300748,annual
2012,2012,1899626,1711770,85235,129680,214915,513317,142068,252449,570563,-21190,534507,12297,558266,.29987499,.31225398,-.012379,.049793489,.12555133,.075757839,annual
2013,2013,1941155,1780336,93990,137890,231880,531790,146281,259734,575443,-25006,556796,-1,575444,.29870203,.31274772,-.014045663,.052793406,.13024507,.077451669,annual
2014,2014,1996725,1863008,92019,144252,236271,525324,155930,259774,576799,-28933,554257,-17918,594717,.28197625,.29750651,-.01553026,.049392704,.12682232,.077429622,annual
2015,2015,2043909,1919641,87850,153827,241677,523366,170836,264548,592946,-28272,551638,-33955,626901,.27263743,.2873652,-.014727754,.045763765,.12589698,.080133215,annual
2016,2016,2079113,1994712,96719,168974,265693,563248,176142,280523,609198,-36113,599361,-42445,651643,.2823706,.30047494,-.018104369,.048487701,.13319868,.084710978,annual
2017,2017,2115296,2068757,105496,181164,286660,622868,182463,292507,642143,-29889,652757,-26754,668897,.30108321,.31553102,-.014447806,.050994873,.1385663,.087571427,annual
2018,2018,2141792,2141792,111356,199113,310469,661601,199113,310469,661601,-25487,687088,-25487,687088,.30890068,.32080051,-.011899848,.051991977,.14495759,.09296561,annual
2019,2019,2172511,2218439,103333,212987,316320,689274,207408,311838,679186,-27470,716744,-26686,705872,.31070226,.32308483,-.012382581,.046579149,.14258675,.0960076,annual
1955-1-15,1955 Q1,116532,4664,14,260,274,1073,6504,8826,15834,-83,1156,1773,14061,.23006004,.24785592,-.017795883,.0030017153,.058747854,.055746142,quarterly
1955-4-15,1955 Q2,116637,4687,27,267,294,994,6230,8281,14170,-68,1062,1201,12969,.21207595,.22658417,-.014508214,.0057606143,.062726691,.056966078,quarterly
1955-7-15,1955 Q3,118997,4860,-7,298,291,1077,6298,7690,15160,-92,1169,1195,13965,.22160494,.24053498,-.01893004,-.0014403292,.059876543,.061316874,quarterly
1955-10-15,1955 Q4,118351,4949,7,261,268,1110,6338,7166,15850,-34,1144,1825,14025,.22428773,.23115781,-.0068700747,.0014144272,.054152355,.052737925,quarterly
1956-1-15,1956 Q1,119735,5083,8,296,304,1154,6557,7890,15866,-5,1159,1707,14159,.22703128,.22801495,-.00098367105,.0015738737,.0598072,.058233328,quarterly
1956-4-15,1956 Q2,119475,5152,22,299,321,1204,6270,7686,16138,42,1162,2258,13880,.23369566,.22554348,.0081521738,.0042701862,.062305901,.058035713,quarterly
1956-7-15,1956 Q3,119357,5233,-8,331,323,1124,6333,7827,15060,-27,1151,1679,13381,.21479075,.21995032,-.0051595643,-.0015287598,.061723676,.063252434,quarterly
1956-10-15,1956 Q4,119891,5364,3,294,297,1202,6303,7822,16474,59,1143,2886,13588,.22408651,.21308725,.010999254,.00055928412,.055369128,.054809842,quarterly
1957-1-15,1957 Q1,122290,5376,40,297,337,1244,6215,8421,16619,2,1242,2209,14410,.23139881,.23102678,.00037202382,.0074404762,.062686011,.055245537,quarterly
1957-4-15,1957 Q2,122303,5458,49,304,353,1259,6066,8198,16453,39,1220,2627,13826,.23067057,.22352511,.0071454747,.0089776479,.064675704,.055698059,quarterly
1957-7-15,1957 Q3,121553,5575,8,342,350,1205,6350,8108,15652,-21,1226,1575,14077,.2161435,.21991031,-.0037668161,.0014349776,.062780268,.06134529,quarterly
1957-10-15,1957 Q4,121774,5684,23,289,312,1217,5872,7878,16225,61,1156,2338,13887,.21410978,.2033779,.010731879,.0040464462,.054890923,.050844476,quarterly
1958-1-15,1958 Q1,124411,5797,52,267,319,1215,6071,8279,16256,80,1135,2322,13934,.20959117,.19579093,.013800241,.0089701572,.055028465,.046058305,quarterly
1958-4-15,1958 Q2,121520,5722,30,302,332,1170,6260,8274,15549,46,1124,1766,13783,.20447396,.19643481,.0080391476,.0052429219,.058021672,.052778747,quarterly
1958-7-15,1958 Q3,124197,5822,5,348,353,1203,6340,8220,15735,-3,1206,1615,14120,.20663002,.2071453,-.00051528687,.00085881143,.060632084,.059773274,quarterly
1958-10-15,1958 Q4,124341,5869,30,284,314,1200,6348,8313,16261,16,1184,1446,14815,.20446414,.20173794,.0027261884,.0051116035,.05350145,.048389845,quarterly
1959-1-15,1959 Q1,125143,5883,55,266,321,1183,5940,8319,15859,30,1153,1507,14352,.20108788,.19598845,.0050994391,.0093489718,.054563999,.045215026,quarterly
1959-4-15,1959 Q2,127218,6078,22,317,339,1246,6512,8337,16376,17,1229,1146,15230,.20500165,.20220467,.0027969726,.0036196117,.055774927,.052155316,quarterly
1959-7-15,1959 Q3,129949,6100,8,358,366,1216,6476,8518,15843,-51,1267,1098,14745,.19934426,.20770492,-.008360656,.0013114754,.059999999,.058688525,quarterly
1959-10-15,1959 Q4,133277,6317,31,294,325,1293,6528,8665,17243,-9,1302,1408,15835,.20468576,.20611049,-.0014247269,.0049073929,.051448472,.04654108,quarterly
1960-1-15,1960 Q1,136599,6421,11,324,335,1320,6991,8709,17458,-60,1380,792,16666,.20557545,.21491979,-.0093443384,.0017131288,.05217256,.05045943,quarterly
1960-4-15,1960 Q2,135553,6482,9,347,356,1317,6976,8907,17275,-87,1404,349,16926,.20317803,.21659982,-.013421783,.0013884604,.054921322,.053532861,quarterly
1960-7-15,1960 Q3,137604,6576,-8,410,402,1285,7136,9102,16431,-158,1443,-49,16480,.19540754,.21943431,-.024026765,-.001216545,.061131388,.062347934,quarterly
1960-10-15,1960 Q4,138426,6710,24,330,354,1326,7177,9400,17688,-77,1403,623,17065,.1976155,.2090909,-.011475409,.0035767511,.052757081,.049180329,quarterly
1961-1-15,1961 Q1,140702,6878,27,341,368,1382,7135,9447,18147,-42,1424,866,17281,.20093051,.20703693,-.0061064265,.0039255596,.053503927,.049578365,quarterly
1961-4-15,1961 Q2,141275,6878,10,368,378,1383,7093,9172,17791,-43,1426,964,16827,.2010759,.20732771,-.0062518176,.0014539111,.054957837,.053503927,quarterly
1961-7-15,1961 Q3,140555,7114,-16,428,412,1350,7082,8969,16858,-51,1401,832,16026,.18976666,.19693562,-.0071689626,-.0022490863,.057913974,.060163058,quarterly
1961-10-15,1961 Q4,140311,7035,27,333,360,1370,6970,9255,17946,24,1346,1647,16299,.19474058,.19132906,.0034115138,.0038379531,.051172707,.047334753,quarterly
1962-1-15,1962 Q1,140941,7130,24,345,369,1371,7236,9415,17802,-30,1401,757,17045,.19228612,.19649369,-.0042075738,.0033660589,.051753156,.048387095,quarterly
1962-4-15,1962 Q2,142246,7304,4,383,387,1441,7175,9070,18381,13,1428,1468,16913,.19728915,.19550931,.0017798466,.00054764515,.052984666,.052437022,quarterly
1962-7-15,1962 Q3,143137,7378,-12,436,424,1385,6840,8990,17127,-76,1461,581,16546,.18772025,.19802114,-.010300894,-.0016264571,.05746815,.059094604,quarterly
1962-10-15,1962 Q4,142573,7412,31,346,377,1425,7125,9344,18335,18,1407,1266,17069,.1922558,.18982731,.0024284944,.0041824067,.050863463,.046681058,quarterly
1963-1-15,1963 Q1,143171,7363,26,342,368,1454,6738,9261,18688,23,1431,1927,16761,.19747385,.19435012,.0031237267,.0035311694,.049979627,.046448458,quarterly
1963-4-15,1963 Q2,149459,7748,-1,392,391,1505,6889,8912,18913,-5,1510,1546,17367,.19424367,.19488901,-.00064532785,-.00012906556,.050464638,.0505937,quarterly
1963-7-15,1963 Q3,150182,7868,-39,476,437,1484,7059,9045,17903,-118,1602,384,17519,.1886121,.20360956,-.014997458,-.004956787,.055541433,.060498219,quarterly
1963-10-15,1963 Q4,153587,8112,15,372,387,1535,7031,9152,19275,-41,1576,1107,18168,.18922584,.19428007,-.0050542406,.0018491125,.047707099,.045857988,quarterly
1964-1-15,1964 Q1,154560,8143,3,384,387,1555,7390,9260,19473,-131,1686,429,19044,.19096155,.207049,-.016087437,.00036841459,.04752548,.047157068,quarterly
1964-4-15,1964 Q2,157401,8432,-13,431,418,1606,7389,9067,19599,-125,1731,318,19281,.1904649,.20528938,-.014824478,-.0015417457,.049573056,.051114801,quarterly
1964-7-15,1964 Q3,158019,8616,-47,513,466,1539,7348,9233,18026,-235,1774,-958,18984,.17862117,.20589601,-.027274838,-.0054549677,.054085422,.059540391,quarterly
1964-10-15,1964 Q4,160431,8852,20,396,416,1619,7290,9453,19833,-119,1738,162,19671,.18289652,.19633982,-.013443289,.0022593765,.046995029,.044735651,quarterly
1965-1-15,1965 Q1,159955,9018,7,397,404,1593,6623,8682,19049,-86,1679,852,18197,.17664671,.18618318,-.0095364824,.00077622535,.044799291,.044023067,quarterly
1965-4-15,1965 Q2,160049,9062,-10,460,450,1710,7529,9450,20393,-72,1782,905,19488,.18870007,.19664533,-.0079452656,-.0011035091,.049657911,.05076142,quarterly
1965-7-15,1965 Q3,161365,9283,-72,550,478,1681,8924,9798,19786,-172,1853,-524,20310,.18108369,.1996122,-.018528493,-.0077561135,.051491976,.059248086,quarterly
1965-10-15,1965 Q4,162354,9463,5,419,424,1755,6784,8820,20686,-28,1783,1257,19429,.18545915,.18841805,-.0029588926,.00052837364,.044806086,.044277713,quarterly
1966-1-15,1966 Q1,162611,9606,11,425,436,1784,6970,8913,20680,-61,1845,721,19959,.18571725,.19206746,-.0063501978,.0011451177,.0453883,.044243183,quarterly
1966-4-15,1966 Q2,163584,9774,8,480,488,1762,7730,9859,20246,-89,1851,445,19801,.1802742,.18937999,-.0091057913,.00081849808,.049928382,.049109884,quarterly
1966-7-15,1966 Q3,164093,9956,-34,584,550,1820,9109,10935,20749,-146,1966,-173,20922,.18280435,.19746886,-.014664524,-.003415026,.055243071,.058658097,quarterly
1966-10-15,1966 Q4,163406,10058,54,426,480,1936,6591,9533,22045,191,1745,3612,18433,.19248359,.17349374,.018989859,.0053688604,.047723204,.042354345,quarterly
1967-1-15,1967 Q1,165604,10160,61,422,483,1894,6307,9226,21456,-26,1920,1218,20238,.18641733,.18897638,-.0025590551,.0060039372,.047539368,.041535433,quarterly
1967-4-15,1967 Q2,167950,10415,31,487,518,1929,7193,9599,21617,-70,1999,352,21265,.18521364,.1919347,-.0067210752,.0029764762,.049735956,.046759482,quarterly
1967-7-15,1967 Q3,168685,10487,14,613,627,1888,9014,11459,20960,-134,2022,-350,21310,.18003242,.19281015,-.012777725,.0013349862,.059788309,.058453321,quarterly
1967-10-15,1967 Q4,169526,10622,45,538,583,1829,8109,10421,19871,-265,2094,-1740,21611,.1721898,.19713801,-.024948221,.0042364905,.054886084,.050649595,quarterly
1968-1-15,1968 Q1,175742,11101,43,525,568,2177,7197,9717,22732,-185,2362,-37,22769,.19610846,.21277362,-.016665164,.003873525,.051166561,.047293037,quarterly
1968-4-15,1968 Q2,175014,11234,87,556,643,2234,7295,10758,23057,-125,2359,771,22286,.1988606,.20998754,-.011126936,.0077443477,.057236958,.049492612,quarterly
1968-7-15,1968 Q3,178468,11589,91,663,754,2351,8778,12584,23921,-120,2471,763,23158,.20286478,.21321943,-.010354646,.007852274,.065061696,.057209421,quarterly
1968-10-15,1968 Q4,179160,11885,112,542,654,2394,7263,10960,24276,-7,2401,1940,22336,.20143038,.20201935,-.00058897771,.0094236434,.055027347,.045603704,quarterly
1969-1-15,1969 Q1,178747,12092,87,571,658,2353,8019,10912,23634,-124,2477,404,23230,.19459146,.20484617,-.010254714,.0071948394,.054416142,.047221303,quarterly
1969-4-15,1969 Q2,180122,12274,99,615,714,2598,8170,11897,26184,56,2542,2805,23379,.21166694,.20710444,.0045624897,.00806583,.058171745,.050105914,quarterly
1969-7-15,1969 Q3,181119,12545,104,724,828,2649,9312,13609,26439,73,2576,2927,23512,.21115983,.20534077,.0058190515,.0082901558,.066002391,.057712235,quarterly
1969-10-15,1969 Q4,181982,12874,92,614,706,2679,7931,11534,26587,94,2585,3393,23194,.20809384,.2007923,.0073015378,.0071461862,.054839212,.047693025,quarterly
1970-1-15,1970 Q1,180827,13228,140,613,753,2746,7146,11343,25762,149,2597,3078,22684,.20758995,.19632597,.011263985,.01058361,.056924704,.046341095,quarterly
1970-4-15,1970 Q2,185094,13806,112,717,829,2932,8068,12226,27147,37,2895,2233,24914,.21237144,.20969144,.0026799941,.0081124147,.060046356,.051933941,quarterly
1970-7-15,1970 Q3,186934,14258,100,902,1002,2888,9881,14616,26236,-19,2907,1631,24605,.20255296,.20388554,-.0013325852,.0070136064,.070276335,.063262731,quarterly
1970-10-15,1970 Q4,188565,14765,91,807,898,3182,8682,13100,28822,182,3000,3438,25384,.21550965,.2031832,.012326447,.0061632236,.060819507,.054656282,quarterly
1971-1-15,1971 Q1,187635,14992,126,772,898,2965,8054,12562,26358,-56,3021,1182,25176,.19777215,.20150746,-.0037353255,.0084044822,.059898611,.051494129,quarterly
1971-4-15,1971 Q2,190988,15499,133,858,991,3397,9045,13648,29861,223,3174,3910,25951,.21917543,.2047874,.014388025,.0085811988,.063939609,.05535841,quarterly
1971-7-15,1971 Q3,194393,15996,152,974,1126,3423,10147,15345,29515,277,3146,3877,25638,.213991,.19667417,.017316829,.0095023755,.070392601,.060890224,quarterly
1971-10-15,1971 Q4,195143,16398,191,815,1006,3426,8610,14032,29585,278,3148,3832,25753,.20892791,.19197462,.016953288,.011647762,.061348945,.049701184,quarterly
1972-1-15,1972 Q1,195374,16596,164,822,986,3274,8638,13381,28047,-72,3346,699,27348,.19727646,.20161484,-.0043383949,.0098818997,.059411906,.049530007,quarterly
1972-4-15,1972 Q2,200521,17383,189,864,1053,3531,9233,14193,29889,119,3412,1815,28074,.2031295,.19628373,.006845769,.010872692,.060576424,.049703732,quarterly
1972-7-15,1972 Q3,201060,17753,148,1056,1204,3223,10432,15727,26615,-213,3436,-332,26947,.18154678,.19354476,-.011997973,.0083366195,.067819521,.059482906,quarterly
1972-10-15,1972 Q4,204205,18821,202,931,1133,3935,9063,14442,31955,40,3895,2194,29761,.20907497,.20694968,.0021252856,.010732693,.060198713,.049466021,quarterly
1973-1-15,1973 Q1,214333,20040,170,961,1131,3886,8581,14345,30860,-425,4311,87,30773,.19391218,.21511976,-.021207584,.0084830336,.056437127,.047954094,quarterly
1973-4-15,1973 Q2,214628,19862,205,1094,1299,4295,9443,15683,32869,-247,4542,2165,30704,.21624207,.22867788,-.012435807,.010321217,.065401271,.055080052,quarterly
1973-7-15,1973 Q3,212585,20547,237,1331,1568,4530,10995,17708,33207,-442,4972,2048,31159,.22047015,.2419818,-.021511655,.011534531,.076312847,.064778313,quarterly
1973-10-15,1973 Q4,211665,21297,271,1214,1485,4863,9182,15403,33655,-679,5542,2183,31472,.22834203,.26022443,-.031882424,.012724797,.069728129,.057003334,quarterly
1974-1-15,1974 Q1,205849,21119,233,1286,1519,5147,8754,15199,33227,-1130,6277,2465,30762,.24371418,.2972205,-.053506322,.011032719,.071925752,.060893036,quarterly
1974-4-15,1974 Q2,208808,22634,266,1437,1703,5936,9886,16629,35677,-1160,7096,3599,32078,.26226032,.31351066,-.051250331,.011752231,.075240791,.063488558,quarterly
1974-7-15,1974 Q3,210128,23880,414,1609,2023,6220,11099,19206,36068,-883,7103,4487,31581,.26046902,.29744557,-.03697655,.017336683,.08471524,.067378558,quarterly
1974-10-15,1974 Q4,207038,24979,342,1432,1774,6262,9624,16838,35041,-929,7191,4156,30885,.25069058,.28788182,-.037191242,.013691501,.071019657,.057328157,quarterly
1975-1-15,1975 Q1,207156,26799,368,1418,1786,6307,9247,16037,32820,-648,6955,3976,28844,.2353446,.25952461,-.024180006,.013731856,.066644281,.052912422,quarterly
1975-4-15,1975 Q2,203755,28112,358,1605,1963,6819,9867,16459,34190,-354,7173,4936,29254,.24256545,.25515795,-.012592487,.012734775,.069827832,.057093058,quarterly
1975-7-15,1975 Q3,203060,29242,463,1895,2358,7034,11189,18932,33880,-557,7591,4019,29861,.24054442,.25959235,-.019047944,.015833391,.08063744,.064804047,quarterly
1975-10-15,1975 Q4,205390,30874,470,1679,2149,7547,9655,16803,35006,-160,7707,5938,29068,.24444516,.24962752,-.0051823542,.015223165,.069605492,.054382328,quarterly
1976-1-15,1976 Q1,208792,32430,624,1559,2183,7868,8722,15742,34793,-85,7953,5972,28821,.24261487,.24523589,-.00262103,.019241443,.067314215,.048072774,quarterly
1976-4-15,1976 Q2,208498,33299,558,1961,2519,8824,9975,17047,36987,-520,9344,5593,31394,.26499295,.28060904,-.015616084,.016757259,.07564792,.058890656,quarterly
1976-7-15,1976 Q3,211146,34523,865,2323,3188,9406,11373,21153,37726,-339,9745,6427,31299,.27245605,.28227559,-.0098195402,.025055761,.092344232,.067288473,quarterly
1976-10-15,1976 Q4,215617,36649,764,2127,2891,10087,9858,18447,38372,-324,10411,7140,31232,.27523261,.28407323,-.0088406233,.020846408,.078883462,.058037054,quarterly
1977-1-15,1977 Q1,215667,38007,739,1929,2668,10230,8913,16190,37387,-384,10614,6370,31017,.26916096,.27926436,-.010103402,.019443786,.070197597,.05075381,quarterly
1977-4-15,1977 Q2,214117,39205,813,2186,2999,11069,9750,17757,39229,-143,11212,7008,32221,.28233644,.28598392,-.0036474939,.020737151,.076495342,.055758193,quarterly
1977-7-15,1977 Q3,215574,40298,1145,2593,3738,11950,11453,22091,41743,968,10982,10500,31243,.29654077,.27251974,.024021043,.02841332,.092758946,.064345628,quarterly
1977-10-15,1977 Q4,219248,42121,935,2186,3121,11318,10023,18526,39119,752,10566,8753,30366,.26870206,.25084874,.017853327,.022197954,.074096054,.051898103,quarterly
1978-1-15,1978 Q1,221203,44092,903,2036,2939,11215,9096,16846,37940,166,11049,5722,32218,.25435454,.25058967,.0037648552,.020479906,.066656083,.046176177,quarterly
1978-4-15,1978 Q2,223770,45856,781,2386,3167,12366,10196,17294,40828,545,11821,6889,33939,.26967028,.25778523,.011885031,.017031576,.069064029,.052032448,quarterly
1978-7-15,1978 Q3,226852,47154,1286,2744,4030,12602,11430,22065,41018,776,11826,8485,32533,.26725197,.25079527,.016456716,.027272342,.085464649,.058192305,quarterly
1978-10-15,1978 Q4,228903,48858,1157,2226,3383,12667,9313,18044,40165,930,11737,9665,30500,.25926152,.24022678,.019034754,.023680871,.069241472,.045560606,quarterly
1979-1-15,1979 Q1,228088,50402,997,2332,3329,11834,9354,16711,36351,-689,12523,3379,32972,.23479228,.24846236,-.013670092,.019780962,.066048965,.046268005,quarterly
1979-4-15,1979 Q2,238126,53904,873,2802,3675,14532,10982,18114,43504,248,14284,7480,36024,.26959038,.26498961,.0046007717,.016195459,.068176761,.0519813,quarterly
1979-7-15,1979 Q3,232811,56698,1309,3282,4591,14698,12458,22161,42870,751,13947,6654,36216,.25923312,.24598752,.013245617,.023087233,.080972873,.057885639,quarterly
1979-10-15,1979 Q4,235228,59717,1282,2800,4082,15462,10346,18245,42864,637,14825,6883,35981,.25892124,.24825427,.010666979,.021467924,.068355747,.046887822,quarterly
1980-1-15,1980 Q1,232982,62025,1043,2789,3832,15839,9981,16802,42073,317,15522,5604,36469,.25536478,.25025392,.0051108422,.0168158,.061781541,.04496574,quarterly
1980-4-15,1980 Q2,228337,63624,812,3263,4075,16021,11426,17518,40920,443,15578,5279,35641,.25180748,.24484472,.0069627813,.012762479,.064048156,.051285677,quarterly
1980-7-15,1980 Q3,228108,65948,1128,3777,4905,16357,13088,20776,41187,1931,14426,8130,33057,.24802876,.21874811,.029280646,.017104385,.074376784,.057272397,quarterly
1980-10-15,1980 Q4,225615,68066,1292,2869,4161,16249,10173,16847,40513,2707,13542,9502,31011,.23872417,.19895396,.039770223,.018981576,.061131842,.042150266,quarterly
1981-1-15,1981 Q1,225484,69863,1284,2706,3990,15773,9307,15985,38591,2683,13090,8878,29713,.22577044,.18736671,.038403735,.018378828,.057111777,.03873295,quarterly
1981-4-15,1981 Q2,226006,71249,913,3504,4417,16773,11551,17073,40014,1939,14834,7476,32538,.23541383,.20819941,.027214417,.012814215,.061993852,.049179636,quarterly
1981-7-15,1981 Q3,228469,73221,1223,4267,5490,18266,13718,21072,42289,1012,17254,6356,35933,.24946395,.23564278,.013821172,.016702859,.074978493,.058275633,quarterly
1981-10-15,1981 Q4,228748,75507,1184,3566,4750,18869,10553,17835,42649,1956,16913,8570,34079,.24989736,.22399248,.025904883,.015680665,.062908076,.047227409,quarterly
1982-1-15,1982 Q1,229165,77381,1344,3129,4473,17764,9806,16240,39753,1247,16517,6223,33530,.2295654,.21345033,.016115068,.017368605,.057804886,.040436283,quarterly
1982-4-15,1982 Q2,231570,78901,766,4034,4800,18636,11907,17000,41429,592,18044,5446,35983,.23619473,.22869165,.0075030737,.0097083692,.06083573,.051127363,quarterly
1982-7-15,1982 Q3,232134,80348,779,4765,5544,19075,13770,19299,41348,1243,17832,6177,35171,.23740479,.22193459,.015470205,.009695325,.068999849,.059304524,quarterly
1982-10-15,1982 Q4,233752,82582,1173,3679,4852,19851,10244,16397,42356,2594,17257,8799,33557,.24037926,.20896806,.031411204,.014204063,.058753725,.044549659,quarterly
1983-1-15,1983 Q1,238082,85542,1476,3490,4966,19686,9110,16108,40707,968,18718,5722,34985,.23013256,.21881649,.011316079,.017254682,.058053356,.040798672,quarterly
1983-4-15,1983 Q2,240053,86316,1081,4174,5255,20073,11120,16773,40975,64,20009,3977,36998,.23255248,.23181102,.00074146158,.01252375,.060880948,.0483572,quarterly
1983-7-15,1983 Q3,242654,88459,1185,5169,6354,21198,13760,19902,42368,778,20420,4770,37598,.23963644,.23084141,.0087950351,.013396037,.071829885,.058433849,quarterly
1983-10-15,1983 Q4,244720,90734,1433,3947,5380,21982,10327,16465,43677,1473,20509,6520,37157,.24226861,.22603434,.016234268,.015793419,.059294201,.043500781,quarterly
1984-1-15,1984 Q1,246424,91524,1599,3869,5468,22373,9750,16241,43405,774,21599,5364,38041,.24444954,.23599274,.0084567983,.017470827,.059743892,.042273063,quarterly
1984-4-15,1984 Q2,244265,93419,1190,4671,5861,22751,11590,16907,43047,-725,23476,2654,40393,.24353719,.25129792,-.0077607338,.012738308,.062738843,.050000533,quarterly
1984-7-15,1984 Q3,245827,94742,1382,5674,7056,23821,13829,20052,44453,-432,24253,3866,40587,.25143021,.25598994,-.0045597516,.014586983,.074475944,.059888963,quarterly
1984-10-15,1984 Q4,250650,97959,1679,4565,6244,26249,10363,17357,47595,497,25752,6018,41577,.26795906,.26288548,.0050735511,.017139824,.063740954,.046601128,quarterly
1985-1-15,1985 Q1,252649,98784,1889,4417,6306,26332,9501,16753,45521,-299,26631,4487,41034,.26656139,.2695882,-.0030268061,.01912253,.063836247,.044713721,quarterly
1985-4-15,1985 Q2,258038,103424,1983,4786,6769,27041,11098,18166,47338,1146,25895,6081,41257,.26145768,.25037709,.0110806,.019173499,.065449022,.046275526,quarterly
1985-7-15,1985 Q3,258279,105007,2215,5661,7876,25849,13644,21535,46839,1330,24519,5992,40847,.24616455,.23349872,.012665822,.021093832,.075004525,.053910691,quarterly
1985-10-15,1985 Q4,258907,107213,2134,4509,6643,26663,10862,18222,48779,2282,24381,7580,41199,.24869186,.22740713,.021284733,.019904302,.061960768,.042056467,quarterly
1986-1-15,1986 Q1,261820,108513,2178,4338,6516,24128,9645,17418,45357,40,24088,4957,40400,.22235124,.22198261,.00036861942,.020071328,.060048103,.039976776,quarterly
1986-4-15,1986 Q2,263767,110330,1723,5124,6847,25243,11846,18624,49465,-703,25946,4684,44781,.22879544,.23516722,-.0063717938,.015616786,.062059276,.04644249,quarterly
1986-7-15,1986 Q3,264966,112166,1720,6479,8199,24950,14909,22189,49034,-1571,26521,3414,45620,.22243817,.23644421,-.014006027,.015334415,.07309702,.0577626,quarterly
1986-10-15,1986 Q4,269702,115626,2233,4887,7120,27358,10231,18523,52064,115,27243,7594,44470,.23660769,.23561309,.00099458604,.019312266,.061577845,.042265579,quarterly
1987-1-15,1987 Q1,272205,117982,2399,4722,7121,26554,9747,18303,49699,133,26421,7093,42606,.22506823,.22394094,.0011272907,.02033361,.060356665,.040023055,quarterly
1987-4-15,1987 Q2,276199,121829,2064,5732,7796,27162,12206,20136,50686,-1175,28337,3961,46725,.22295184,.2325965,-.0096446658,.016941778,.063991331,.047049552,quarterly
1987-7-15,1987 Q3,282910,126800,2070,7466,9536,28876,16433,24364,53369,-1582,30458,2977,50392,.22772871,.24020505,-.012476341,.016324921,.07520505,.058880128,quarterly
1987-10-15,1987 Q4,286114,129529,2086,5475,7561,28953,11797,19355,54367,-870,29823,5265,49102,.22352524,.23024188,-.0067166425,.016104503,.05837303,.042268526,quarterly
1988-1-15,1988 Q1,291209,133105,1986,5441,7427,26643,11353,18676,50261,-2769,29412,1902,48359,.20016529,.22096841,-.020803126,.014920551,.055798054,.040877502,quarterly
1988-4-15,1988 Q2,292929,136147,1621,6309,7930,28107,13539,19760,52799,-3628,31735,-200,52999,.20644598,.23309363,-.026647668,.011906249,.058245867,.04633962,quarterly
1988-7-15,1988 Q3,297391,140831,1564,7920,9484,29333,16858,22974,53269,-4633,33966,-2433,55702,.20828511,.2411827,-.032897588,.011105509,.067343131,.056237619,quarterly
1988-10-15,1988 Q4,299952,145524,1805,6121,7926,29395,12705,18910,53586,-4060,33455,-1510,55096,.20199417,.22989336,-.027899178,.012403453,.054465242,.042061791,quarterly
1989-1-15,1989 Q1,301273,148564,1765,6168,7933,29288,12387,18656,52066,-4827,34115,-2695,54761,.19714062,.22963168,-.032491047,.011880402,.05339786,.041517459,quarterly
1989-4-15,1989 Q2,303257,151393,1767,7075,8842,31661,13801,20042,54189,-5626,37287,-3796,57985,.2091312,.24629276,-.037161559,.011671609,.058404285,.046732675,quarterly
1989-7-15,1989 Q3,303558,155573,1508,9131,10639,32703,17523,23760,55116,-5971,38674,-4025,59141,.21021,.24859069,-.038380697,.0096931988,.068385899,.058692705,quarterly
1989-10-15,1989 Q4,303849,158994,1909,6799,8708,35081,12306,19063,58217,-1889,36970,2862,55355,.22064355,.2325245,-.011880952,.012006742,.054769363,.042762619,quarterly
1990-1-15,1990 Q1,305893,162181,2516,6719,9235,34095,12081,19347,55655,-4037,38132,-661,56316,.21022809,.23512001,-.024891941,.015513531,.056942552,.04142902,quarterly
1990-4-15,1990 Q2,307471,166693,1790,7942,9732,35591,14280,20122,57569,-4136,39727,-1202,58771,.21351227,.23832434,-.02481208,.010738303,.058382776,.047644474,quarterly
1990-7-15,1990 Q3,304257,169806,1790,9565,11355,35171,17621,24133,57243,-3369,38540,-1142,58385,.20712461,.22696489,-.019840289,.010541442,.066870429,.056328986,quarterly
1990-10-15,1990 Q4,303210,170251,2105,7250,9355,37133,12933,19967,60603,407,36726,5921,54682,.21810739,.21571679,.0023905879,.012364098,.054948281,.042584185,quarterly
1991-1-15,1991 Q1,302325,173302,2070,6672,8742,32666,11835,18508,53418,-1840,34506,1484,51934,.18849176,.19910906,-.010617304,.011944467,.050443735,.038499266,quarterly
1991-4-15,1991 Q2,301943,175408,1777,8260,10037,36380,14531,19476,57719,-956,37336,2213,55506,.20740217,.21285231,-.0054501505,.010130667,.05722088,.047090214,quarterly
1991-7-15,1991 Q3,301285,177054,2211,9844,12055,37292,16755,23376,58468,-1246,38538,2333,56135,.21062501,.21766241,-.0070374012,.012487716,.068086572,.055598855,quarterly
1991-10-15,1991 Q4,301811,179700,2335,7653,9988,38423,12865,19416,61097,1434,36989,6808,54289,.21381748,.2058375,.0079799667,.012993879,.055581525,.042587645,quarterly
1992-1-15,1992 Q1,301831,181341,2817,7581,10398,36004,12955,20416,57147,-857,36861,2301,54846,.19854307,.20326898,-.0047259033,.01553427,.057339486,.041805219,quarterly
1992-4-15,1992 Q2,301474,181762,1983,9126,11109,38081,15817,21801,60043,-1663,39744,429,59614,.20951024,.21865956,-.0091493269,.010909871,.061118387,.050208513,quarterly
1992-7-15,1992 Q3,303395,182216,1240,10583,11823,37027,17530,24335,59539,-2960,39987,-424,59963,.20320389,.21944834,-.016244458,.0068051103,.064884536,.058079422,quarterly
1992-10-15,1992 Q4,305506,185259,2932,8359,11291,41372,13271,21537,63946,583,40789,6229,57717,.22331978,.22017284,.0031469457,.015826492,.060947105,.045120616,quarterly
1993-1-15,1993 Q1,307712,189690,3387,8403,11790,41985,12372,21440,60739,-231,42216,3470,57269,.22133482,.22255258,-.0012177763,.017855449,.06215404,.044298593,quarterly
1993-4-15,1993 Q2,309236,190122,1883,10209,12092,42069,15341,21775,60821,-2373,44442,788,60033,.22127371,.23375517,-.012481459,.0099041667,.063601263,.053697098,quarterly
1993-7-15,1993 Q3,311683,193481,2682,12259,14941,44246,18282,26755,63596,-1406,45652,1643,61953,.22868395,.23595081,-.0072668632,.013861827,.077222049,.063360229,quarterly
1993-10-15,1993 Q4,313765,195866,3324,9564,12888,45640,13944,22865,65772,1307,44333,5756,60016,.23301645,.22634353,.0066729295,.016970785,.065800086,.048829302,quarterly
1994-1-15,1994 Q1,317468,198814,3733,9700,13433,45458,14240,23009,65237,379,45079,4844,60393,.22864588,.22673957,.0019063044,.018776344,.067565665,.048789322,quarterly
1994-4-15,1994 Q2,321166,200550,1760,11393,13153,46521,16647,23228,66385,-1997,48518,2116,64269,.23196709,.2419247,-.0099576162,.0087758666,.065584645,.056808777,quarterly
1994-7-15,1994 Q3,324811,202863,2900,13482,16382,49299,19566,28684,69757,-60,49359,5661,64096,.24301623,.24331199,-.00029576611,.014295362,.080754004,.066458642,quarterly
1994-10-15,1994 Q4,326734,207259,3461,10791,14252,51085,15533,23899,71864,1438,49647,7661,64203,.24647905,.23954086,.006938179,.016698914,.068764202,.052065291,quarterly
1995-1-15,1995 Q1,328056,208283,5405,10107,15512,53361,14401,25082,72803,4144,49217,10821,61982,.25619471,.2362987,.019896006,.02595027,.074475594,.048525322,quarterly
1995-4-15,1995 Q2,329292,210739,2610,12265,14875,52396,17241,25278,72297,-2145,54541,4543,67754,.24862982,.25880828,-.010178467,.012384988,.070584938,.058199953,quarterly
1995-7-15,1995 Q3,332436,214461,3183,14423,17606,54676,20085,30043,75684,-1664,56340,6669,69015,.25494611,.26270512,-.0077589867,.014841859,.082094178,.067252323,quarterly
1995-10-15,1995 Q4,333055,216698,4238,11452,15690,56827,15810,25610,77294,1982,54845,9739,67555,.26224053,.25309417,.00914637,.019557172,.072404914,.052847743,quarterly
1996-1-15,1996 Q1,334982,220219,3670,11747,15417,56954,15758,25396,76576,155,56799,7515,69061,.25862437,.25792053,.00070384482,.01666523,.070007585,.053342354,quarterly
1996-4-15,1996 Q2,336145,224881,3760,13469,17229,58658,18090,27299,78318,-1591,60249,5402,72916,.26084018,.26791504,-.0070748529,.016719954,.076613851,.059893899,quarterly
1996-7-15,1996 Q3,340034,229294,4152,15320,19472,59868,20819,30925,80270,-1,59869,6095,74175,.2610971,.26110145,-4.3612131e-06,.018107757,.084921539,.066813782,quarterly
1996-10-15,1996 Q4,344637,232871,4838,13099,17937,61771,18425,28526,84071,2962,58809,9442,74629,.26525846,.25253895,.012719489,.02077545,.077025481,.056250028,quarterly
1997-1-15,1997 Q1,351195,233985,5090,11906,16996,58902,17205,28110,85360,2463,56439,11373,73987,.25173408,.24120776,.010526316,.021753531,.072637133,.050883602,quarterly
1997-4-15,1997 Q2,354286,235563,4096,13633,17729,60421,20073,29626,89123,-392,60813,7955,81168,.25649613,.25816023,-.0016640984,.01738813,.075262241,.057874113,quarterly
1997-7-15,1997 Q3,356780,242589,4734,16145,20879,62250,23781,33912,91185,1071,61179,9465,81720,.25660685,.25219199,.0044148746,.019514488,.086067379,.066552892,quarterly
1997-10-15,1997 Q4,360993,239613,4097,13352,17449,61733,20324,29895,92817,1115,60618,10630,82187,.25763628,.25298294,.0046533369,.017098404,.072821595,.055723187,quarterly
1998-1-15,1998 Q1,364276,243273,4936,12861,17797,59406,19504,30678,90415,-76,59482,8620,81795,.24419479,.24450719,-.00031240622,.020289963,.073156498,.052866533,quarterly
1998-4-15,1998 Q2,367660,246876,4111,14695,18806,60139,21944,32341,91921,-2148,62287,5852,86069,.24360003,.25230074,-.0087007247,.016652085,.076175891,.05952381,quarterly
1998-7-15,1998 Q3,370263,250242,3938,16882,20820,60539,25125,35532,92884,-2932,63471,4556,88328,.24192181,.25363848,-.011716658,.015736766,.083199464,.067462698,quarterly
1998-10-15,1998 Q4,373826,256856,4363,14824,19187,60750,21627,31622,92773,-1590,62340,5958,86815,.23651384,.24270408,-.006190239,.016986171,.074699439,.05771327,quarterly
1999-1-15,1999 Q1,376026,257971,4213,14524,18737,57811,21447,31419,89117,-4138,61949,2642,86475,.22409883,.24013939,-.016040564,.016331293,.072632194,.056300901,quarterly
1999-4-15,1999 Q2,376682,256599,3888,16682,20570,60947,24782,33871,92755,-3783,64730,2447,90308,.23751846,.25226131,-.014742848,.015152046,.080163993,.065011948,quarterly
1999-7-15,1999 Q3,383148,260238,3161,18550,21711,64045,27892,35611,96790,-4698,68743,1162,95628,.24610165,.26415434,-.018052706,.012146574,.083427481,.071280904,quarterly
1999-10-15,1999 Q4,388806,264944,5025,16086,21111,66063,24317,34048,99633,-2288,68351,4383,95250,.24934703,.25798282,-.0086357873,.018966272,.079680987,.060714718,quarterly
2000-1-15,2000 Q1,391937,270734,4935,14996,19931,64878,22722,33266,98365,-3472,68350,3598,94767,.23963743,.25246182,-.012824396,.018228224,.073618382,.055390161,quarterly
2000-4-15,2000 Q2,394312,273515,4440,17456,21896,68189,25804,35696,101821,-4514,72703,2568,99253,.24930625,.26580992,-.016503666,.016233113,.080054112,.063820995,quarterly
2000-7-15,2000 Q3,395469,275409,3705,20445,24150,70003,29672,39412,103794,-7111,77114,170,103624,.25417835,.27999812,-.02581978,.013452719,.087687768,.074235044,quarterly
2000-10-15,2000 Q4,396403,276242,5299,17377,22676,73064,25604,36490,108106,-4457,77521,3484,104622,.26449272,.28062713,-.016134404,.019182457,.082087442,.062904991,quarterly
2001-1-15,2001 Q1,401021,278908,6428,16868,23296,73442,24498,36454,107833,-4695,78137,2186,105647,.26331979,.2801533,-.016833508,.023047026,.083525747,.060478725,quarterly
2001-4-15,2001 Q2,404118,285103,5340,18997,24337,72539,26869,37653,105542,-7430,79969,-1916,107458,.25443086,.28049162,-.026060756,.018730072,.085362129,.066632062,quarterly
2001-7-15,2001 Q3,407236,285857,3401,21706,25107,70462,30979,38901,103189,-8557,79019,-4746,107935,.24649388,.27642843,-.029934548,.011897557,.087830625,.075933069,quarterly
2001-10-15,2001 Q4,408833,288507,5434,17562,22996,70358,25228,35363,104539,-5232,75590,-1451,105990,.2438693,.26200405,-.018134741,.018834898,.079706907,.060872007,quarterly
2002-1-15,2002 Q1,410434,291400,5161,17530,22691,68778,25520,35685,102783,-6766,75544,-3669,106452,.23602608,.25924504,-.023218943,.017711051,.077868909,.060157858,quarterly
2002-4-15,2002 Q2,412445,294478,3912,19940,23852,73651,28139,36013,108102,-8651,82302,-6761,114863,.25010696,.27948436,-.029377406,.013284524,.080997564,.067713037,quarterly
2002-7-15,2002 Q3,415187,298755,4789,23202,27991,74202,33117,42511,109299,-8281,82483,-6582,115881,.24837074,.2760891,-.027718365,.016029857,.093692154,.077662297,quarterly
2002-10-15,2002 Q4,418465,303038,6038,19320,25358,71089,27612,37799,105472,-8223,79312,-6867,112339,.23458774,.26172295,-.02713521,.019924894,.083679274,.06375438,quarterly
2003-1-15,2003 Q1,421580,307070,7961,19353,27314,74942,27588,41176,108863,-4397,79339,-2381,111244,.24405511,.2583743,-.01431921,.025925685,.088950403,.063024715,quarterly
2003-4-15,2003 Q2,425428,310584,5827,21516,27343,74170,29473,40109,106879,-7218,81388,-6526,113405,.23880818,.26204827,-.023240089,.01876143,.088037372,.069275945,quarterly
2003-7-15,2003 Q3,430274,316568,5242,25182,30424,76004,34350,44168,109182,-8925,84929,-8005,117187,.24008743,.26828045,-.028192995,.016558843,.096105732,.079546891,quarterly
2003-10-15,2003 Q4,434277,321966,6594,20304,26898,75429,28495,40379,110644,-7572,83001,-5444,116088,.23427629,.25779429,-.023518011,.020480424,.08354298,.063062556,quarterly
2004-1-15,2004 Q1,435802,322897,8033,20313,28346,73797,29342,43245,109606,-7421,81218,-6310,115916,.22854656,.25152913,-.02298256,.024877902,.087786511,.062908605,quarterly
2004-4-15,2004 Q2,437406,329033,6598,22894,29492,76620,32103,44292,111763,-9366,85986,-8716,120479,.23286419,.26132941,-.02846523,.020052699,.089632347,.069579646,quarterly
2004-7-15,2004 Q3,438191,330791,5683,26213,31896,79401,36662,48256,115232,-10854,90255,-10615,125847,.24003373,.27284598,-.03281226,.017180033,.096423425,.079243392,quarterly
2004-10-15,2004 Q4,439291,334738,9423,22644,32067,83663,31031,47316,119252,-6153,89816,-4912,124164,.24993578,.26831731,-.01838154,.028150374,.095797308,.067646936,quarterly
2005-1-15,2005 Q1,442793,337926,8834,22208,31042,78667,31211,47755,113581,-8393,87060,-7135,120716,.23279357,.25763038,-.024836799,.026141819,.091860346,.065718532,quarterly
2005-4-15,2005 Q2,447996,346983,9033,24639,33672,86902,33571,46769,120715,-7737,94639,-8779,129494,.25045031,.27274823,-.022297923,.026032975,.097042218,.071009241,quarterly
2005-7-15,2005 Q3,452721,349720,7907,28502,36409,90267,38356,53647,127795,-10624,100891,-7362,135157,.25811219,.2884908,-.030378589,.022609517,.104109,.081499487,quarterly
2005-10-15,2005 Q4,458925,358409,10288,24452,34740,93269,32873,48560,129747,-7196,100465,-4903,134650,.26023063,.28030825,-.020077622,.028704636,.096928373,.06822373,quarterly
2006-1-15,2006 Q1,461059,361619,11778,24779,36557,101957,33626,52904,142923,-8690,110647,-4684,147607,.28194591,.30597672,-.024030818,.032570191,.10109258,.068522394,quarterly
2006-4-15,2006 Q2,462305,366410,9789,26753,36542,107488,35092,50599,147532,-8224,115712,-5374,152906,.29335445,.31579924,-.022444801,.026715973,.099729814,.073013835,quarterly
2006-7-15,2006 Q3,462734,369568,11970,30256,42226,96759,40247,59065,132882,-8952,105711,-6771,139653,.2618165,.28603938,-.024222877,.032389168,.11425773,.081868559,quarterly
2006-10-15,2006 Q4,464891,373122,13986,25386,39372,94958,33328,53798,131072,-5376,100334,-2476,133548,.25449586,.268904,-.014408156,.037483718,.10552045,.068036728,quarterly
2007-1-15,2007 Q1,469274,378624,15100,25005,40105,93486,33546,57909,132452,-7384,100870,-3214,135666,.24690986,.26641205,-.019502198,.039881255,.10592303,.066041775,quarterly
2007-4-15,2007 Q2,471920,383376,13086,27700,40786,97301,35805,57318,134805,-6861,104162,-2003,136808,.25380045,.27169672,-.017896269,.034133591,.10638642,.072252825,quarterly
2007-7-15,2007 Q3,475530,389461,13031,31330,44361,98653,40569,61469,135869,-11492,110145,-8515,144384,.25330648,.28281394,-.029507447,.033459064,.11390357,.080444515,quarterly
2007-10-15,2007 Q4,477958,394624,16313,26856,43169,102669,34467,61017,140125,-5860,108529,1192,138933,.26016918,.27501875,-.014849578,.041338082,.10939274,.068054654,quarterly
2008-1-15,2008 Q1,480523,400688,13103,27838,40941,100578,35061,59385,134852,-10352,110930,-1345,136197,.25101325,.27684882,-.025835562,.032701254,.10217676,.069475502,quarterly
2008-4-15,2008 Q2,477834,398915,13639,29649,43288,109583,35269,59721,138504,-9281,118864,439,138065,.27470264,.29796824,-.023265608,.034190241,.10851435,.074324101,quarterly
2008-7-15,2008 Q3,470368,397188,11948,33989,45937,111424,39371,62003,138909,-10614,122038,-49,138958,.28053215,.307255,-.026722861,.030081473,.11565556,.085574083,quarterly
2008-10-15,2008 Q4,460676,392468,17332,29434,46766,108254,33890,58104,133115,-4441,112695,3635,129480,.27582887,.28714442,-.011315572,.044161562,.11915876,.074997194,quarterly
2009-1-15,2009 Q1,452896,384441,16355,28495,44850,99486,32197,55666,121853,-6039,105525,1459,120394,.25878093,.27448946,-.015708523,.04254229,.1166629,.074120604,quarterly
2009-4-15,2009 Q2,452036,385619,15143,30415,45558,100294,34137,57272,123126,-5480,105774,967,122159,.26008573,.27429664,-.014210918,.039269332,.11814252,.078873187,quarterly
2009-7-15,2009 Q3,452595,389776,13058,33573,46631,102636,37408,59034,126082,-8382,111018,-2829,128911,.26332048,.28482512,-.021504659,.033501294,.11963538,.086134084,quarterly
2009-10-15,2009 Q4,454145,388677,15633,28406,44039,106335,32235,55497,128574,-4970,111305,805,127769,.27358192,.28636888,-.012786967,.040221058,.11330488,.073083818,quarterly
2010-1-15,2010 Q1,457058,394878,14980,28097,43077,105091,31743,53941,124345,-6542,111633,-2005,126350,.26613536,.28270251,-.016567143,.037935767,.10908939,.071153626,quarterly
2010-4-15,2010 Q2,461765,401588,16903,30844,47747,114748,33712,57488,132461,-5383,120131,-570,133031,.28573564,.29913992,-.013404285,.042090401,.11889549,.076805085,quarterly
2010-7-15,2010 Q3,465134,403451,13177,34574,47751,113510,37930,57303,132646,-12388,125898,-7552,140198,.28134766,.31205276,-.030705092,.032660719,.11835638,.085695662,quarterly
2010-10-15,2010 Q4,465290,406110,19196,29664,48860,120354,32882,58902,139278,-6810,127164,78,139200,.29635814,.31312698,-.016768856,.047267981,.12031223,.073044248,quarterly
2011-1-15,2011 Q1,466970,414242,18016,28559,46575,122321,31923,55758,138149,-2981,125302,4115,134034,.29528874,.30248502,-.0071962764,.043491486,.11243428,.068942793,quarterly
2011-4-15,2011 Q2,467370,411759,21563,31978,53541,128398,34306,62896,141289,-976,129374,7344,133945,.31182805,.31419834,-.0023703186,.052368011,.13002995,.077661932,quarterly
2011-7-15,2011 Q3,468942,414864,19944,35410,55354,128678,37790,66064,143139,-8792,137470,1885,141254,.3101691,.33136159,-.021192487,.048073586,.13342686,.08535327,quarterly
2011-10-15,2011 Q4,469556,419276,21900,30723,52623,130493,33651,61508,144350,-3088,133581,6011,138339,.31123412,.31859919,-.0073650768,.052232895,.12550922,.073276311,quarterly
2012-1-15,2012 Q1,472809,421447,21019,29895,50914,129054,33345,60479,142983,-3548,132602,5566,137417,.30621645,.31463507,-.008418615,.049873412,.1208076,.070934184,quarterly
2012-4-15,2012 Q2,472114,423697,20866,33231,54097,127157,36085,62716,140377,-6160,133317,1165,139212,.30011305,.31465176,-.014538691,.049247459,.12767851,.078431047,quarterly
2012-7-15,2012 Q3,477869,432624,18967,36250,55217,128192,39333,65166,143499,-8211,136403,538,142961,.29631272,.31529227,-.018979529,.043841764,.12763277,.083791003,quarterly
2012-10-15,2012 Q4,476834,434002,24383,30304,54687,128914,33305,64088,143704,-3271,132185,5028,138676,.29703549,.30457234,-.0075368318,.05618177,.12600634,.069824561,quarterly
2013-1-15,2013 Q1,479357,436035,24273,30906,55179,128775,33507,62414,139018,-3338,132113,3665,135353,.29533181,.30298716,-.0076553486,.055667549,.12654719,.070879631,quarterly
2013-4-15,2013 Q2,483211,440203,25329,35113,60442,137178,36678,67675,148219,-1323,138501,5833,142386,.31162441,.31462985,-.0030054315,.057539362,.13730483,.079765469,quarterly
2013-7-15,2013 Q3,487728,449241,20384,38907,59291,133999,40527,66227,144491,-9830,143829,-3292,147783,.29827866,.32016,-.021881351,.045374308,.13198039,.086606078,quarterly
2013-10-15,2013 Q4,490859,454857,24004,32964,56968,131838,35569,63418,143715,-10515,142353,-6207,149922,.28984493,.31296209,-.023117155,.05277263,.12524375,.072471127,quarterly
2014-1-15,2014 Q1,494629,459591,21756,32260,54016,126217,35347,60073,138364,-6871,133088,-3472,141836,.27462897,.28957921,-.014950249,.047337741,.11753058,.070192844,quarterly
2014-4-15,2014 Q2,497849,463641,23798,35580,59378,132161,37897,64967,143994,-3751,135912,-500,144494,.28505027,.29314059,-.0080903117,.051328506,.12806891,.076740406,quarterly
2014-7-15,2014 Q3,500658,468959,20127,40482,60609,130489,43380,67332,143961,-11548,142037,-8170,152131,.27825248,.30287722,-.024624754,.042918462,.12924157,.086323112,quarterly
2014-10-15,2014 Q4,503589,470817,26338,35930,62268,136457,39306,67402,150480,-6763,143220,-5776,156256,.28983024,.30419463,-.014364392,.055941056,.13225521,.076314151,quarterly
2015-1-15,2015 Q1,506314,473838,21795,34977,56772,125810,38934,61911,141038,-11748,137558,-13204,154242,.26551268,.29030597,-.024793284,.045996733,.1198131,.073816366,quarterly
2015-4-15,2015 Q2,510095,480944,22823,38812,61635,135340,43078,67879,152543,-1389,136729,-1359,153902,.28140491,.28429297,-.0028880702,.047454588,.12815422,.080699623,quarterly
2015-7-15,2015 Q3,512070,481713,16585,42721,59306,127123,47117,66522,146842,-12392,139515,-12224,159066,.26389781,.28962266,-.025724862,.034429215,.1231148,.088685587,quarterly
2015-10-15,2015 Q4,515430,483146,26647,37317,63964,135093,41707,68236,152523,-2743,137836,-7168,159691,.27961114,.28528851,-.0056773727,.055153102,.13239062,.077237524,quarterly
2016-1-15,2016 Q1,516456,489770,22492,36641,59133,128139,40465,63893,144466,-8960,137099,-12650,157116,.26163098,.27992526,-.018294301,.045923598,.12073626,.074812666,quarterly
2016-4-15,2016 Q2,518794,497175,25896,40151,66047,140888,42737,71595,156464,-2674,143562,-3240,159704,.28337708,.28875548,-.0053783879,.052086286,.13284457,.080758281,quarterly
2016-7-15,2016 Q3,520379,500613,18434,49451,67885,139622,49295,70653,148256,-21884,161506,-22371,170627,.27890205,.32261646,-.043714408,.036822855,.13560376,.098780893,quarterly
2016-10-15,2016 Q4,523484,507154,29897,42731,72628,154599,43645,74382,160012,-2595,157194,-4184,164196,.30483639,.30995318,-.0051167891,.058950536,.143207,.084256455,quarterly
2017-1-15,2017 Q1,526081,512085,25370,41047,66417,149406,42211,68067,154108,-8810,158216,-9718,163826,.29176015,.30896434,-.017204175,.049542557,.12969917,.080156617,quarterly
2017-4-15,2017 Q2,527622,513953,27030,45374,72404,156408,45805,73733,161746,-4330,160738,-3992,165738,.30432355,.31274843,-.0084248949,.052592359,.1408767,.088284336,quarterly
2017-7-15,2017 Q3,529856,517482,23067,51515,74582,156496,50714,76518,161904,-12958,169454,-10337,172241,.30241826,.32745874,-.025040485,.044575464,.14412482,.099549353,quarterly
2017-10-15,2017 Q4,531737,525237,30029,43228,73257,160558,43733,74189,164385,-3791,164349,-2707,167092,.30568677,.31290445,-.0072176941,.057172287,.13947418,.082301892,quarterly
2018-1-15,2018 Q1,532104,527869,27532,44394,71926,156714,44976,73185,160977,-6058,162772,-4927,165904,.29688048,.30835682,-.011476332,.05215688,.13625729,.08410041,quarterly
2018-4-15,2018 Q2,534140,532966,28688,48772,77460,164975,49076,77108,165149,-1936,166911,-3020,168169,.30954131,.31317383,-.0036325019,.053827073,.1453376,.091510527,quarterly
2018-7-15,2018 Q3,537326,539287,23477,55359,78836,166527,54299,79059,164735,-10878,177405,-9893,174628,.30879104,.32896212,-.020171078,.043533407,.14618561,.10265221,quarterly
2018-10-15,2018 Q4,538222,541670,31659,50588,82247,173385,50762,81117,170740,-6615,180000,-7647,178387,.32009342,.33230564,-.012212233,.058447026,.15183969,.093392655,quarterly
2019-1-15,2019 Q1,541195,548802,24062,46693,70755,161313,47183,71550,162059,-25606,186919,-25497,187556,.29393661,.34059459,-.046657994,.043844592,.12892628,.085081689,quarterly
2019-4-15,2019 Q2,541944,551964,27299,52005,79304,164104,50680,77793,160935,-6078,170182,-7120,168055,.29730925,.30832082,-.011011587,.049457937,.14367604,.094218098,quarterly
2019-7-15,2019 Q3,544639,558286,20018,62080,82098,174748,58111,81057,170948,-12377,187125,-8280,179228,.31300804,.33517766,-.02216964,.035856172,.14705366,.11119749,quarterly
2019-10-15,2019 Q4,544733,559387,31954,52209,84163,189109,51434,81438,185244,16591,172518,14211,171033,.3380647,.30840546,.029659253,.057123244,.15045577,.093332522,quarterly
2020-1-15,2020 Q1,528287,554315,26751,46454,73205,156024,46796,70362,153359,-1975,157999,-4420,157779,.28147173,.28503469,-.0035629561,.048259564,.1320639,.083804332,quarterly
2020-4-15,2020 Q2,429219,476341,31161,37830,68991,140540,36411,64312,140359,20204,120336,19149,121210,.29504073,.25262573,.042414993,.065417424,.14483532,.079417899,quarterly
2020-7-15,2020 Q3,497909,540164,30223,36425,66648,140128,34255,64822,138995,-2540,142668,-1307,140302,.2594175,.26411977,-.0047022756,.055951525,.12338475,.067433223,quarterly
